Hh^Fds, Gg, Gs^Fds, Gg, Gs^Fds, Gg, Gs^Fds, Gg, Gs^Fds, Gg, Gg, Gs^Fds, Gg, Gg, Gg, Gg, Gg, Gs^Fds, Gs^Fds, Gg, Gg, Gg, Gg, Gg, Gg, Gg, Gg
Gs^Fds, Gs^Fds, Gg^Ve, Gs^Fds, Gs^Fds, Gs^Fds, Gs^Fds, Gs^Fds, Gs^Fds, Gs^Fds, Gg^Ve, Gg, Gg, Gg, Gg, Gs^Fds, Gs^Fds, Gs^Fds, Gs^Fds, Gs^Fds, Gg, Gs^Fds, Gs^Fds, Gg, Gg, Gg, Gg
Gg, Gs^Fds, Gs^Fds, Gs^Fds, Gs^Fds, Gs^Fds, Gs^Fds, Gs^Fds, Gs^Fds, Gg, Gg, Gg, Gg, Gg, Gs^Fds, Cv, Gs^Fds, Gs^Fds, Gs^Fds, Gs^Fds, Gs^Fds, Gs^Fds, Gs^Fds, Gs^Fds, Gs^Fds, Gg, Gg
Gs^Fds, Gs^Fds, Gs^Fds, Gs^Fds, Gs^Fds, Gs^Fds, Gs^Fds, Gs^Fds, Gg, Gg, Gg, Gg, Gg, Gg, Gs^Fds, Gs^Fds, Gll^Fdw, Gs^Fds, Gll^Fdf, Gll^Fdw, Gd^Fetd, Gll^Fdf, Gll^Fdf, Gs^Fds, Gs^Fds, Gg, Gg
Gs^Fds, Gs^Fds, Gs^Fds, Gs^Fds, Gs^Fds, Gs^Fds, Gs^Fds, Gg, Gs^Fds, Gg, Gg, Gs^Fds, Gs^Fds, Gs^Fds, Gd^Fetd, Gs^Fds, Gll^Fdw, Gll^Fdw, Gll^Fdw, Gs^Fds, Gll, Gll^Fdw, Gll^Fdw, Gs^Fds, Cv, Gs^Fds, Gg
Gs^Fds, Gs^Fds, Gs^Fds, Gg, Gs^Fds, Gg, Gg, Gg, Gg, Gg, Gg, Gs^Fds, Cv, Gs^Fds, Gll^Fdw, Gs, Gd, Gd^Fetd, Gd, Gll, Gll, Gll^Fdw, Gd^Fetd, Gll^Fdw, Gs^Fds, Gs^Fds, Gg
Gg, Gg, Gg, Gg, Gg, Gg, Gs^Fds, Gg, Gg, Gg, Gg, Gs^Fds, Gll^Fdf, Gll^Fdf, Gd^Fetd, Gll^Fdw, Gd, Gd, Gll, Gd, Gd, Gs, Gll^Fdw, Gll^Fdw, Gll^Fdf, Gs^Fds, Gs^Fds
Gg, Gs^Fds, Gg, Gs^Fds, Gg, Gg, Gg, Gg, Gg, Gg, Gg, Gs^Fds, Gll^Fdf, Gll^Fdw, Gs, Gll, Gd, Gll, Gg^Fet, Gll, Gd, Gll^Fdw, Gd^Fetd, Gs^Fds, Gll^Fdf, Gs^Fds, Gs^Fds
Gg, Gg, Gg, Gs^Fds, Gg, Gg, Gg, Gg, Gg, Gg, Gs^Fds, Gs^Fds, Gs^Fds, Gll^Fdw, Gs^Fds, Gs, Gd, Gd, 1 Gll, Gll, Gd, Gd, Gll^Fdw, Gll^Fdw, Gs^Fds, Gs^Fds, Gg
Gg, Gg, Gg, Gg, Gg, Gg, Gg, Gg, Gg, Gg, Gg, Gg, Gg, Gll^Fdf, Gll^Fdw, Gd^Fetd, Gd, Gd, Rb, Gd, Gll, Gd^Fetd, Gll^Fdw, Gll^Fdf, Gs^Fds, Gs^Fds, Gg
Gs^Fds, Gg, Gg, Gs^Fds, Gg, Gg, Gg, Gg, Gg, Gg, Gg, Gg, Gg, Gs^Fds, Gg, Gs, Gs, Gs, Re, Gll, Gs, Gs, Gs, Gs^Fds, Gs^Fds, Gg, Gg
Re, Gs^Fds, Re, Gg, Gg, Gg, Gg, Gg, Ww, Gg, Ww, Ww, Ww, Cv, Cv, Gg, Kv, Gs, Rb, Kv, Cv, Cv, Gg, Gs^Fds, Gg, Gg, Gg
Gg, Re, Gg, Gg, Gg, Re, Gg, Ww, Ww, Ww, Ww^Ewf, Ww, Ww, Ww, Ww, Cv, Ww, Ww^Bsb|, Ww^Bsb|, Ww, Ww, Ww, Gg, Gg, Gg, Gg, Gg
Gg, Gg, Gg, Gg, Ww, Ww, Wwr, Ww, Ww, Ww^Ewl, Ww, Ww, Ww, Ww, Ww, Ww, Ww, Ww^Bsb|, Ww^Bsb|, Ww, Ww, Ww, Cv, Gg, Gg, Gg, Gg
Ww, Ww, Ww, Ww, Ww, Ww, Ww, Wwr^Bw\r, Gg, Ww, Gg, Gg, Gg, Ww, Gg, Ww, Cv, Ww^Bsb|, Ww^Bsb|, Ww, Ww, Ww, Ww, Gg, Gg, Gs^Vh, Gg
Ww, Ww, Ww, Ww^Ewl, Ww, Ww, Gg, Gg, Gg, Gg, Gg, Gg, Gg, Gg, Gg, Gg, Gg, Gg, Gg, Cv, Ww, Ww, Ww, Gg, Ww, Gg, Gg
Ww, Ww, Ww, Ww, Gg, Gg, Gg, Gg, Gg, Re, Re, Re, Gg, Gg, Gg, Re, Re, Re, Gg, Gg, Gg, Ww, Wwf, Ww, Ww, Gg, Ww
Gg, Gg, Gg, Gg, Gg, Gg, Gg, Gg, Gg, Gg, Gg^Eff, Gg^Eff, Gg^Eff, Gg, Gg, Gg, Gg, Gg, Gg, Gg, Gg, Gg, Gg, Ww, Ww, Ww, Ww
Gg, Gg, Gg, Gg, Gg, Gg, Gg, Gg, Gg, Gg^Eff, Re^Gvs, Re^Gvs, Gg^Gvs, Gg^Eff, Gg, Gg, Gg, Gg, Gg, Gg, Gg, Gg, Gg, Ww, Ww, Ww, Ww
Gg, Gg, Gg, Gg, Gg, Gg, Gg, Gg, Gg, Gg^Gvs, Gg^Gvs, Re^Gvs, Gg^Eff, Gg^Eff, Gg, Gg, Gg, Gg, Gg, Gg, Gg, Gg, Gg, Gg, Gg, Ww, Ww
Gg, Gg, Gg, Gg, Gg, Gg, Gg, Gg, Re, Gs^Vh, Gg, Gg, Gg, Gg, Gg, Gg, Gg, Gg, Gg, Gg, Gg, Gg, Gg, Gg, Gg, Gg, Gg
Gg^Eff, Gg, Gg, Gg, Gg, Gg, Gg, Gg, Re, Gg, Gg, Gg, Gg, Gg, Gg, Gg, Gg, Gg, Gg, Gg, Gg, Gg, Gg, Gg, Gg, Gs^Vh, Gg
Gg^Gvs, Gg^Eff, Gg, Gg, Gg, Gg, Re, Re, Gg, Gg, Gg, Gg, Gg, Gg, Gg, Gg, Gg, Gg, Gg, Gg, Gg, Gg, Gg, Gg, Gg, Gg, Gg
Gg, Gg, Gg, Gg, Gg, Gg, Gg, Gg, Gg, Gg, Gg, Gg, Gg, Gg, 2 Gg, Gg, Gg, Gg, Gg, Gg, Gg, Gg, Gg, Gg, Gg, Gg, Gg
Gg, Gg, Gg, Gg, Gg, Gg, Gg, Gg, Gg, Gg, Gg, Gg, Gg, Gg, Gg, Gg, Gg, Gg, Gg, Gg, Gg, Gg, Gg, Gg, Gg, Gg, Gg
