border_size=1
usage=map

Mm, Mm, Mm, Mm, Mm, Mm, Mm, Mm, Hh, Hh^Fds, Hh^Fds, Gs^Fds, Gs^Fds, Re, Re, Gs^Fds, Gs^Fds, Gs^Fds, Gs^Fds, Gs^Fds, Gs^Fds, Gs^Fds, Gs^Fds, Gs^Fds, Gs^Fds, Gs^Fds, Gs^Fds, Gs^Fds, Gs^Fds, Gs^Fds, Gs^Fms, Gs^Fds, Gs^Fds, Gs^Fds, Gs^Fds, Gs^Fds, Gs^Fds, Gs^Fds, Gg, Re, Gs^Fds, Gs^Fds
Mm, Mm, Mm, Mm, Mm, Mm, Mm, Mm, Hh, Hh^Fds, Hh, Gs^Fds, Gs^Fds, Re, Re, Gs^Fds, Gs^Fds, Gs^Fds, Gs^Fds, Gs^Fds, Gs^Fds, Gs^Fds, Gs^Fds, Gs^Fds, Gs^Fds, Gs^Fds, Gs^Fds, Gs^Fds, Gs^Fds, Gs^Fds, Gs^Fds, Gs^Fds, Gs^Fds, Gs^Fds, Gs^Fds, Gs^Fds, Gs^Fds, Gs^Fds, Re, Re, Gs^Fds, Gs^Fds
Mm, Mm, Mm, Mm, Mm, Mm, Mm, Mm, Mm, Hh, Hh, Hh, Gs^Fds, Gs^Fds, Re, Gs^Fds, Gs^Fds, Gs^Fds, Gs^Fds, Gs^Fds, Gs^Fds, Gs^Fds, Gs^Fds, Gg^Fet, Gs^Fds, Gs^Fds, Gs^Fds, Gs^Fds, Gs^Fds, Gs^Fds, Gs^Fds, Gs^Fds, Gg, Gs^Fds, Re, Gs^Fds, Gs^Fds, Gs^Fds, Re, Gs^Fds, Gs^Fds, Gs^Fds
Mm, Mm, Mm, Mm, Mm, Mm, Mm, Mm, Mm, Mm, Hh, Hh^Fds, Hh^Fds, Gs^Fds, Re, Gs^Fds, Gs^Fds, Gs^Fds, Gs^Fds, Gs^Fds, Gs^Fds, Gs^Fds, Gs^Fds, Gs^Fds, Gs^Fds, Gs^Fds, Gg, Gs^Fds, Re, Re, Re, Re, Re, Re, Gs^Fp, Re, Re, Re, Gg, Gg, Gg, Gg
Hh, Hh, Hh, Mm, Mm, Mm, Mm, Mm, Mm, Mm, Hh, Hh^Fds, Hh, Gs^Fds, Gs^Fds, Re, Re, Gs^Fds, Gs^Fds, Gg^Fet, Gs^Fds, Gs^Fds, Gs^Fds, Gs^Fds, Rp, Rp, Re, Re, Hh^Fds, Gg, Gg, Gg, Gs^Fds, Gg, Gg, Gg, Gg, Gg, Gs^Fds, Gs^Fds, Gs^Fds, Gs^Fds
Hh, Hh, Hh, Hh, Hh, Mm, Hh^Fds, Mm, Mm, Hh, Hh, Hh, Hh, Hh, Hh^Fds, Gs^Fds, Gs^Fds, Re, Re^Ve, Gs^Fds, Gs^Fds, Gs^Fds, Gs^Fds, Gs^Fds, Rp, Gg^Ve, Gg, Gs^Fds, Hh^Fp, Hh^Fds, Hh, Hh, Hh^Fds, Gs^Fds, Gs^Fds, Gs^Fds, Gs^Fds, Gs^Fms, Gs^Fds, Gs^Fds, Gs^Fds, Gs^Fds
Gs^Fds, Gs^Fds, Gs^Fds, Gs^Fds, Hh, Hh, Hh, Hh^Fds, Gs^Fds, Hh^Fds, Hh, Hh, Hh, Hh^Fds, Hh^Fds, Gs^Fds, Gs^Fds, Re, Rp, Gs^Fds, Rp, Rp, Rp, Gs^Fds, Rp, Gg, Gs^Fds, Gs^Fds, Hh, Hh^Fds, Mm, Hh^Fds, Hh^Fds, Hh^Fds, Gs^Fds, Gs^Fds, Gs^Fds, Gs^Fds, Gg, Gs^Fds, Gs^Fds, Gs^Fds
Gs^Fds, Gs^Fds, Gg, Gs^Fds, Gs^Fds, Hh, Gg, Gs^Fds, Gs^Fds, Gs^Fds, Gs^Fds, Hh, Gs^Fds, Hh, Gs^Fds, Gs^Fds, Gs^Fds, Gs^Fds, Gs^Fds, Rp, Gg, Gg^Ve, Gg, Rp, Gg^Ve, Rp, Rp, Gs^Fds, Gs^Fds, Hh, Hh, Hh, Hh^Fds, Gs^Fds, Gs^Fds, Gg, Gs^Fds, Gs^Fds, Gs^Fds, Gs^Fds, Gs^Fds, Gs^Fds
Gs^Fds, Gs^Fds, Gs^Fds, Gs^Fds, Gs^Fds, Gs^Fds, Gs^Fds, Gg, Gs^Fds, Gs^Fds, Gs^Fds, Gs^Fds, Gs^Fds, Gs^Fds, Gs^Fds, Gs^Fds, Gs^Fds, Gs^Fds, Gs^Fds, Rp, Gg, Gg, Gg, Gg^Fet, Gg^Efm, Gg, Gg^Ve, Rp, Rp, Gs^Fds, Gg, Hh, Gs^Fds, Gs^Fds, Gs^Fds, Gs^Fds, Gs^Fds, Gs^Fds, Gs^Fds, Gs^Fds, Gs^Fds, Gs^Fds
Hh^Fds, Gs^Fds, Gs^Fds, Gs^Fds, Gs^Fms, Gs^Fds, Hh, Gs^Fds, Gs^Fds, Gs^Fds, Gg, Gs^Fds, Gg, Gs^Fds, Gg, Gg, Gg, Gs^Fds, Gs^Fds, Rp, Rp, Gs^Fds, Gs^Fds, Gg, Gg, Gg, Gg, Gg, Gg, Rp, Gg, Gg, Gg, Gg, Gg, Gs^Fds, Gs^Fds, Gs^Fds, Gg, Gs^Fds, Gs^Fds, Gs^Fds
Hh^Fds, Hh^Fds, Gs^Fds, Gg^Ve, Rp, Hh, Gg, Gs^Fds, Gg, Gs^Fds, Gs^Ve, Gg, Rp, Gg, Gg, Gg, Rp, Gg, Rp, Gg, Rp, Gg^Ve, Gg^Fet, Gs^Fds, Hh^Fds, Gg, Gg, Gs, Gg, Rp, Rp, Gg, Gg, Gg, Gg, Gg, Gs^Fds, Gs^Fds, Gs^Fds, Gg, Gg, Gg
Hh^Fds, Hh^Fds, Gs^Fds, Gs^Fds, Rp, Gs^Fms, Rp, Rp, Rp, Rp, Rp, Rp, Gg, Rp, Rp, Rp, Hh, Rp, Gg, Rp, Gg, Gs^Fds, Gs^Fds, Hh^Fds, Hh^Fds, Hh^Fds, Hh, Gg, Gg, Gg, Gg^Ve, Rp, Gg, Gg, Gg, Gg, Gg, Gs^Fds, Gg^Fet, Gs^Fds, Gs^Fds, Gs^Fds
Hh^Fds, Hh^Fds, Gs^Fds, Gs^Fds, Gg, Rp, Gg, Gg, Gg, Gg, Gg, Gg, Gs^Fds, Gg, Gg^Ve, Hh, Hh, Hh, Mm, Rp, Rp, Gs^Fds, Hh, Hh, Mm, Hh, Hh, Gg, Gg, Gg, Gg, Rp, Rp, Gg, Gg, Gg, Gg, Gs^Fds, Gs^Fds, Gs^Fds, Gs^Fds, Gs^Fds
Gs^Fds, Gs^Fds, Gs^Fds, Gg, Gs^Ve, Rp, Rp, Gg, Gg, Gg, Gg, Gg, Gs^Fds, Gs^Fds, Hh, Gg, Hh, Mm, Mm, Mm, Cv, Hh, Kv, Mm, Mm, Mm, Hh, Hh, Hh, Gg, Gg, Gg, Rp, Gg^Ve, Gs^Fds, Gs^Fds, Gs^Fds, Gg, Gs^Fds, Gs^Fds, Gg, Gg
Gs^Fds, Gs^Fds, Gs^Fds, Gs^Fds, Gs^Fms, Gg, Gg, Rp, Rp, Gg, Gs^Fds, Gg, Mm, Mm, Mm, Hh, Mm, Mm, Cv^Cvw, Mm, Gg^Fet, Cv, Hh^Fds, Hh^Fds, Gs^Fds, Mm, Hh^Fds, Hh, Hh, Gg, Gg, Gg^Ve, Rp, Gg, Gs^Fds, Hh^Fds, Hh^Fds, Gs^Fds, Gg, Gg^Efm, Gs^Fds, Gs^Fds
Gs^Fds, Gs^Fds, Gs^Fds, Gs^Fds, Gs^Fds, Gs^Fds, Gs^Fds, Gg, Gg^Ve, Gs^Fds, Hh^Fds, Hh, Mm, Mm, Mm, Mm, Mm, Mm, Mm, Gg^Ve, Cv, 2 Kv, Cv, Gs^Fds, Gg^Fet, Hh^Fds, Hh^Fds, Hh, Gs^Fds, Gs^Fds, Rp, Gg, Rp, Gg, Gs^Fds, Hh^Fds, Hh, Hh, Hh^Fds, Gg, Gs^Fds, Gs^Fds
Gs^Fds, Gs^Fms, Gs^Fds, Gs^Fds, Gs^Fds, Gs^Fds, Gs^Fds, Gs^Fds, Hh^Fms, Gs^Fds, Hh, Hh, Mm, Mm, Mm, Mm, Hh, Hh, Mm, Hh, Hh, Rp, Rp, Gs^Fds, Gs^Fds, Gs^Fds, Gs^Fds, Gs^Fds, Rp, Rp, Gg, Rp, Gg, Gg^Efm, Gg, Gs^Fds, Gg, Gs^Fds, Gg, Hh^Fds, Gs^Fds, Gs^Fds
Gs^Fds, Gs^Fds, Gs^Fds, Gs^Fds, Gs^Fds, Gs^Fds, Hh, Hh^Fms, Hh, Hh, Hh, Mm, Mm, Mm, Hh, Mm, Hh, Mm, Mm, Mm, Hh^Fds, Gs^Fds, Gg^Ve, Rp, Gg, Gg, Gs^Ve, Rp, Gs^Fds, Gg, Gg, Gg, Gs^Fds, Gs^Fds, Gs^Fds, Gs^Fds, Gs^Fds, Gg, Hh, Gs^Fds, Gs^Fds, Gs^Fds
Gs^Fds, Gs^Fds, Gs^Fds, Gs^Fds, Gs^Fds, Gs^Fds, Hh^Fds, Hh, Hh, Hh, Hh, Mm, Mm, Mm, Hh, Hh, Hh, Mm, Mm, Mm, Hh, Gs^Fds, Rp, Rp, Rp, Rp, Rp, Rp, Gg^Fet, Gs^Fds, Gg, Gs^Fds, Gs^Fds, Gs^Fds, Gg, Gs^Fds, Gs^Fds, Hh^Fds, Hh, Hh^Fds, Gs^Fds, Gs^Fds
Gs^Fds, Gs^Fds, Gs^Fds, Gs^Fds, Gs^Fds, Hh^Fds, Hh, Hh^Fds, Hh, Hh, Hh, Hh, Hh, Hh, Hh^Fds, Hh, Hh, Gg^Ve, Hh, Hh, Rp, Rp, Gs^Fds, Gg, Gg, Gg, Rp, Gs^Fds, Gs^Fds, Gs^Fds, Hh, Hh, Hh, Gs^Fds, Gs^Fds, Gs^Fds, Mm, Hh^Fds, Hh, Hh, Hh, Hh^Fds
Gs^Fds, Gs^Fds, Gs^Fds, Gs^Fds, Gs^Fds, Hh^Fds, Hh, Hh, Hh, Hh, Hh^Fds, Hh^Fds, Gs^Fds, Gs^Fds, Gs^Fds, Hh^Fds, Gg, Gg, Rp, Rp, Gg^Ve, Rp, Gg^Ve, Gs^Fds, Gs^Fds, Gg, Gg^Ve, Gg, Gg^Efm, Gs^Fds, Hh, Hh, Hh, Hh, Hh, Gs^Fds, Hh^Fds, Mm, Mm, Mm, Hh, Hh
Gs^Fds, Gs^Fds, Gg, Gs^Fds, Gg, Gg, Hh^Fds, Hh, Hh, Hh^Fds, Mm, Gs^Fds, Gs^Fds, Gg^Fet, Gs^Fds, Gs^Fds, Gg^Ve, Rp, Gs^Fds, Gs^Fds, Gs^Fds, Rp, Gs^Fds, Gs^Fet, Gs^Fds, Gg, Gs^Fds, Gg, Gg, Gg, Gg, Gs^Fds, Gs^Fds, Hh, Hh, Mm, Mm, Hh, Mm, Mm, Mm, Mm
Gg, Gg, Gg, Gs^Fds, Gg, Gs^Fds, Hh, Hh, Mm, Mm, Mm, Gs^Fds, Gs^Fds, Gs^Fds, Hh^Fds, Gs^Fds, Gs^Fds, Rp, Rp, Gs^Fds, Gs^Fds, Gg^Ve, Gs^Fds, Gs^Fds, Gs^Fds, Gs^Fds, Gs^Fds, Gs^Fds, Gg, Hh^Fds, Gs^Fds, Gs^Fds, Gs^Fds, Gs^Fds, Mm, Hh, Mm, Hh, Hh, Mm, Mm, Mm
Gg, Gg, Gs^Fds, Gs^Fds, Hh^Fds, Hh, Mm, Mm, Mm, Mm, Mm, Mm, Hh^Fds, Hh^Fds, Hh, Gs^Fds, Gg, Gg, Rp, Gs^Fds, Gs^Fds, Gs^Fds, Gs^Fet, Gs^Fds, Gs^Fds, Gs^Fds, Gg^Fet, Gs^Fds, Gs^Fds, Hh, Hh^Fds, Gs^Fds, Mm, Hh, Mm, Mm, Mm, Mm, Mm, Mm, Mm, Mm
Gs^Fds, Gs^Fds, Gs^Fds, Gs^Fds, Hh^Fds, Hh^Fds, Mm, Mm, Mm, Mm, Mm, Mm, Hh, Hh, Hh, Hh, Hh, Re, Gs^Fds, Gg^Ve, Gs^Fds, Gs^Fds, Gs^Fds, Gs^Fds, Gs^Fds, Gs^Fds, Gs^Fds, Gs^Fds, Gs^Fds, Gs^Fds, Hh, Hh, Mm, Mm, Mm, Hh, Hh, Mm, Mm, Mm, Mm, Mm
Gg, Gg, Gg, Gs^Fds, Hh, Hh, Mm, Mm, Mm, Mm, Hh, Hh, Hh, Hh, Hh, Hh, Hh, Re, Gs^Fds, Gs^Fds, Gs^Fds, Gg^Fet, Gs^Fds, Gs^Fds, Gs^Fds, Gs^Fds, Ww, Ww, Ww, Gs^Fds, Ww, Ww, Ww, Mm, Mm, Mm, Hh, Hh, Mm, Mm, Mm, Mm
Ww, Ww, Ww, Gg, Hh, Hh, Mm, Mm, Mm, Mm, Hh, Hh^Fds, Gs^Fds, Gs^Fds, Hh, Hh, Re, Re, Gs^Fds, Gs^Fds, Gs^Fds, Gs^Fds, Gs^Fds, Gs^Fds, Gs^Fds, Ww, Ww, Ww, Ww, Ww, Wo, Wo, Ww, Ww, Hh^Fds, Mm, Hh, Hh^Fds, Mm, Mm, Mm, Mm
Gg, Gg, Gg, Ww, Hh^Fds, Hh, Hh, Mm, Mm, Mm, Hh, Hh, Gg^Fet, Gs^Fds, Gg, Gs^Fds, Re, Gg, Gg, Gg^Fet, Gs^Fds, Gs^Fds, Gs^Fds, Gs^Fds, Ww, Ww, Ww, Ww, Ww, Wo, Wo, Ww, Hh, Ww, Hh^Fds, Mm, Mm, Mm, Mm, Mm, Hh, Hh
Gs^Fds, Gs^Fds, Gs^Fds, Ww, Hh^Fds, Hh, Ww, Ww, Ww, Hh, Hh^Fds, Gs^Fds, Gs^Fds, Re, Re, Re, Hh, Hh, Hh^Fds, Hh^Fds, Mm, Hh, Hh^Fds, Ww, Ww, Ww, Wo, Ww, Ww, Ww, Ww, Ww, Ww, Hh^Fds, Mm, Mm, Mm, Mm, Mm, Hh, Hh^Fds, Hh
Gs^Fds, Gs^Fds, Gs^Fds, Ww, Ww, Gg, Ww, Gg, Gs^Fds, Ww, Gs^Fds, Gg^Fet, Gg, Gg, Re, Hh, Hh, Mm, Mm, Mm, Mm, Mm, Hh, Ww, Ww, Wo, Wo, Wo, Ww, Ww, Ww, Ww, Gll^Fdf, Hh, Gll^Fdf, Mm, Mm, Mm, Hh^Fds, Hh^Fds, Hh, Hh
Gs^Fds, Gs^Fds, Gg, Gs^Fds, Gg, Ww, Gg, Gs^Fds, Gs^Fds, Ww, Gg, Gg, Gg, Gg, Re, Hh, Mm, Mm, Mm, Mm, Mm, Hh, Hh^Fds, Ww, Ww, Wo, Wo, Ww, Ww, Ww, Ww, Ww, Gd, Gll^Fdf, Gll^Fdf, Ww, Ww, Hh, Hh, Hh, Hh^Fds, Hh^Fds
Gg, Gg, Gs^Fds, Gs^Fds, Gs^Fds, Gs^Fds, Gs^Fds, Gg, Ww, Ww, Gg, Gs^Fds, Re, Re, Gs^Fds, Hh, Mm, Mm, Mm, Mm, Mm, Hh, Hh^Fds, Ww, Ww, Ww, Ww, Ww, Ww, Ww, Ww, Gll^Fdw, Gd^Fetd, Gll^Fdw, Ww, Ww, Ww, Hh^Fds, Hh^Fds, Hh^Fds, Hh^Fds, Hh^Fds
Gs^Fds, Gs^Fds, Gs^Fds, Gs^Fds, Gs^Fds, Gs^Fds, Gg, Gg, Ww, Gs^Fds, Hh, Gg^Ve, Re, Gs^Fds, Gg^Ve, Mm, Mm, Mm, Mm, Mm, Mm, Mm, Hh^Fds, Hh, Gs^Fds, Ww, Ww, Ww, Ww, Ww, Gd^Fetd, Gd, Gd, Gll^Fdw, Ww, Wo, Wo, Ww, Ww, Hh, Mm, Mm
Hh, Hh, Gs^Fds, Gs^Fds, Gg, Gg, Ww, Ww, Gs^Fds, Gs^Fds, Hh, Hh, Re, Gs^Fds, Gs^Fds, Hh^Fds, Hh, Mm, Mm, Mm, Mm, Mm, Hh^Fds, Hh^Fds, Gs^Fds, Ww, Ww, Ww, Ww, Gll^Fdw, Gd, Gd, Gll^Fdw, Gll^Fdw, Ww, Wo, Ww, Ww, Ww, Mm, Mm, Mm
Hh, Hh^Fds, Hh^Fds, Gs^Fds, Gg, Ww, Gs^Fds, Gs^Fds, Hh^Fds, Hh, Gs^Fds, Hh, Gs^Fds, Re, Gs^Fds, Gg, Gs^Fds, Gg, Gg, Hh, Hh, Mm, Hh, Hh^Fds, Gs^Fds, Ww, Gs, Ww, Gll^Fdf, Gll^Fdw, Gll^Fdw, Gll^Fdw, Ww, Ww, Ww, Ww, Ww, Ww, Ww, Hh, Mm, Mm
Hh, Hh^Fds, Hh, Gs^Fds, Gs^Fds, Ww, Ww, Gs^Fds, Ww, Hh^Fds, Ww, Gg^Ve, Gs^Fds, Re, Gg^Ve, Gs^Fds, Gs^Fds, Gs^Fds, Ww, Hh^Fds, Ww, Hh, Ww, Ww, Ww, Ww, Gs^Fds, Gll^Fdf, Gll^Fdf, Ww, Ww, Ww, Wo, Wo, Ww, Ww, Ww, Ww, Hh, Hh, Mm, Mm
Mm, Mm, Mm, Gs^Fds, Gs^Fds, Gs^Fds, Gs^Fds, Ww, Gs^Fds, Ww, Gs^Fds, Ww, Ww, Ww^Bw|, Ww, Hh^Fds, Ww, Ww, Gg, Ww, Gs^Fds, Ww, Gg, Gs^Fds, Gs^Fds, Gs^Fds, Gs^Fds, Gs^Fds, Gs^Fds, Ww, Gs^Fds, Ww, Ww, Wo, Ww, Ww, Wo, Ww, Ww, Mm, Mm, Mm
Mm, Mm, Mm, Mm, Hh, Gs^Fds, Gg, Gs^Fds, Gg, Gs^Fds, Re, Gg^Ve, Re, Re, Re, Ww, Gs^Fds, Gs^Fds, Gs^Fds, Gs^Fds, Gs^Fds, Gs^Fds, Gs^Fds, Gs^Fds, Gs^Fds, Gs^Fds, Gg, Gg, Hh^Fds, Gs^Fds, Mm, Hh^Fds, Hh, Ww, Ww, Ww, Wo, Wo, Ww, Ww, Mm, Mm
Mm, Mm, Hh^Fds, Hh, Gs^Fds, Gg, Re, Re, Re, Ce, Gs^Fds, Re, Gg^Fet, Gs^Fds, Gs^Fds, Re, Gs^Fds, Gs^Fds, Gs^Fds, Gs^Fds, Gg, Gs^Fds, Gs^Fds, Gs^Fds, Hh^Fds, Gs^Fds, Hh, Gs^Fds, Hh^Fds, Hh^Fds, Mm, Mm, Mm, Mm, Mm, Ww, Ww, Ww, Hh, Hh, Mm, Mm
Mm, Mm, Hh^Fds, Gg, Gs^Fds, Re, Gs^Fds, Ce, Ce, Ce, Ce, Gg^Fet, Gs^Fds, Gs^Fds, Gs^Fds, Gg^Ve, Gs^Fds, Gg^Fet, Gs^Fds, Gs^Fds, Hh^Fds, Gs^Fds, Hh, Hh, Hh, Hh, Mm, Hh, Hh, Hh, Mm, Mm, Mm, Mm, Mm, Mm, Mm, Ww, Mm, Mm, Mm, Mm
Hh, Hh^Fds, Gs^Fds, Gs^Fds, Gg, Re, Gs^Fds, Gg^Fet, Ce, 1 Ke, Ce, Ce, Gs^Fds, Gs^Fds, Gs^Fds, Gs^Fds, Gs^Fds, Gs^Fds, Gs^Fds, Gs^Fds, Hh, Hh, Hh^Fds, Mm, Mm, Mm, Mm, Mm, Mm, Hh, Mm, Mm, Hh, Hh, Hh, Hh, Mm, Mm, Mm, Mm, 3 Mm, Mm
Hh, Hh, Gs^Fds, Gs^Fds, Gg, Re, Gs^Fds, Gs^Fds, Gs^Fds, Gs^Fds, Gs^Fds, Gs^Fds, Gs^Fds, Gs^Fds, Gs^Fds, Gs^Fds, Gs^Fds, Gs^Fds, Gs^Fds, Gs^Fds, Hh^Fds, Hh^Fds, Hh^Fds, Mm, Mm, Mm, Mm, Mm, Mm, Hh, Mm, Mm, Hh, Hh, Hh, Hh, Mm, Mm, Mm, Mm, Mm, Mm
