Gs^Fds, Gs^Fds, Gs^Fds, Gs^Fds, Gs^Fds, Gs^Fds, Gs^Fds, Gs^Fds, Gs^Fds, Gs^Fds, Rr, Gs^Fds, Gs^Fds, Gs^Fds, Gs^Fds, Gs^Fds, Gs^Fds, Gs^Fds, Gs^Fds, Gs^Fds
Gs^Fds, Gs^Fds, Gs^Fds, Gs^Fds, Gs^Fds, Gs^Fds, Gs^Fds, Gs^Fds, Rr, Rr, Gg^Ve, Rr, Rr, Gs^Fds, Gs^Fds, Gs^Fds, Gs^Fds, Gs^Fds, Gs^Fds, Gs^Fds
Gs^Fds, Gs^Fds, Gs^Fds, Gs^Fds, Gs^Fds, Gs^Fds, Rr, Rr, Gg^Ve, Gs^Fds, Cv, Gs^Fds, Gg^Ve, Rr, Rr, Gs^Fds, Gs^Fds, Gs^Fds, Gs^Fds, Gs^Fds
Gs^Fds, Gs^Fds, Gs^Fds, Gs^Fds, Gs^Fds, Rr, Gg^Ve, Gs^Fds, Cv, Cv, Gg^Fet, Cv, Cv, Gg, Gg^Ve, Rr, Gs^Fds, Gs^Fds, Gs^Fds, Gs^Fds
Gs^Fds, Gs^Fds, Gs^Fds, Gs^Fds, Rr, Rr, Cv, Cv, Gs^Fds, Gg, Gg, Gg, Gs^Fds, Cv, Cv, Rr, Rr, Gs^Fds, Gs^Fds, Gs^Fds
Gs^Fds, Gs^Fds, Gs^Fds, Gs^Fds, Rr, Gg^Ve, Cv, Gs^Fds, Cv, Cv, Gg^Fet, Cv, Cv, Gs^Fds, Cv, Gg^Ve, Rr, Gs^Fds, Gs^Fds, Gs^Fds
Gs^Fds, Gs^Fds, Gs^Fds, Rr, Gg^Ve, Cv, Gs^Fds, Gs^Fds, Cv, 2 Kv, Gg, Kv, Cv, Gg, Gg, Cv, Gg^Ve, Rr, Gs^Fds, Gs^Fds
Gs^Fds, Gs^Fds, Gs^Fds, Rr, Rr, Cv, Gg, Gg^Fet, Gs^Fds, Gg^Ii, Gg, Gg^Ii, Gs^Fds, Gg^Fet, Gs^Fds, Cv, Rr, Rr, Gs^Fds, Gs^Fds
Gs^Fds, Gs^Fds, Gs^Fds, Gs^Fds, Rr, Cv, Cv, Gs^Fds, Gg, Gg^Ii, Cv, Gg^Ii, Gs^Fds, Gs^Fds, Cv, Cv, Rr, Gs^Fds, Gs^Fds, Gs^Fds
Gs^Fds, Gs^Fds, Gs^Fds, Gs^Fds, Rr, Gg^Ve, Gg, Gs^Fds, Gs^Fds, Gg^Ii, Gg, Gg^Ii, Gg, Gs^Fds, Gs^Fds, Gg^Ve, Rr, Gs^Fds, Gs^Fds, Gs^Fds
Gs^Fds, Gs^Fds, Gs^Fds, Gs^Fds, Gs^Fds, Rr, Rr, Gs^Fds, Gs^Fds, Gg^Ii, Rr, Gg^Ii, Gs^Fds, Gs^Fds, Rr, Rr, Gs^Fds, Gs^Fds, Gs^Fds, Gs^Fds
Gs^Fds, Gs^Fds, Gs^Fds, Gs^Fds, Gs^Fds, Gs^Fds, Gs^Fds, Rr, Rr, Rr, 1 Rp, Rr, Rr, Rr, Gs^Fds, Gs^Fds, Gs^Fds, Gs^Fds, Gs^Fds, Gs^Fds
Gs^Fds, Gs^Fds, Gs^Fds, Gs^Fds, Gs^Fds, Gs^Fds, Gs^Fds, Gs^Fds, Gs^Fds, Gs^Fds, Rp, Gs^Fds, Gs^Fds, Gs^Fds, Gs^Fds, Gs^Fds, Gs^Fds, Gs^Fds, Gs^Fds, Gs^Fds
Gs^Fds, Gs^Fds, Gs^Fds, Gs^Fds, Gs^Fds, Gs^Fds, Gs^Fds, Gs^Fds, Gs^Fds, Gs^Fds, Rp, Gs^Fds, Gs^Fds, Gs^Fds, Gs^Fds, Gs^Fds, Gs^Fds, Gs^Fds, Gs^Fds, Gs^Fds
