Gs^Fds, Gs^Fds, Gs^Fds, Gs^Fds, Gs^Fds, Gs^Fds, Gs^Fds, Gs^Fds, Gs^Fds, Gs^Fds, Gg, Gs^Fds, Gg, Gg, Gg, Gs^Fds, Gg, Gg, Gg, Gg, Gg, Gg, Gg, Gg, Gg, Gg, Gg, Gg, Gg, Gg, Gg, Gg, Gg, Gg, Gg, Gg, Gg, Gg, Gg, Gg, Gg, Gg, Gg, Gg, Gg, Gg
Gs^Fds, Gs^Fds, Gs^Fds, Gs^Fds, Gs^Fds, Gs^Fds, Re^Vct, Gs^Fds, Gs^Fds, Gs^Fds, Gs^Fds, Gg, Gg, Gs^Fds, Gs^Fds, Gg, Gs^Fds, Gg, Gg, Gg, Gg, Gg, Gg, Gg, Gg, Gg, Gg^Eff, Gg, Gg^Eff, Gg^Eff, Re^Eff, Gg, Gg, Gg, Gg, Gg, Gg, Gg, Gg, Gg, Gg, Gg, Gg, Gg, Gg, Gg
Gs^Fds, Gs^Fds, Gs^Fds, Gll^Fmf, Gs^Fds, Ce, 4 Ke, Ce, Ce, Gs^Fds, Gs^Fds, Gs^Fds, Gs^Fds, Gg, Gs^Fds, Gg, Gs^Fds, Gg, Gs^Fds, Gg, Gg, Gg, Gg, Gg, Gg, Gg^Eff, Gg^Gvs, Gg^Eff, Re^Gvs, Re^Gvs, Gg^Gvs, Gg, Gs^Vh, Gg, Gg, Gg, Gg, Gg, Gg, Gg, Gg, Gg, Gg, Gg, Gg, Gg
Gs^Fds, Gs^Fds, Gs^Fds, Gs^Fds, Gg^Ve, Ce, Ce, Ce, Re^Vct, Gs^Fds, Gs^Fds, Gs^Fds, Gs^Fds, Gs^Fds, Gs^Fds, Gg, Gg, Gs^Fds, Gg, Gs^Fds, Gg, Gg, Gg, Gs^Vh, Gg^Gvs, Gg^Gvs, Re^Gvs, Re^Gvs, Gg^Gvs, Gg^Gvs, Re^Gvs, Re^Gvs, Gg^Eff, Gg, Gg, Gg, Gg, Gg, Gg, Gg, Gg, Gg, Gs^Vh, Gg, Gg, Gg
Gs^Fds, Gs^Fds, Gs^Fds, Gll^Fmf, Gs^Fds, Gs^Fds, Gs^Fds, Gs^Fds, Gs^Fds, Gs^Fds, Gs^Fds, Gs^Fds, Gll^Fmf, Gs^Fds, Gs^Fds, Gg, Gg, Gs^Fds, Gs^Fds, Gs^Fds, Gs^Fds, Gg, Gg, Gg^Eff, Re^Eff, Re^Gvs, Gg^Gvs, Gg^Gvs, Re^Gvs, Re^Gvs, Gg, Gg^Eff, Gg, Gg, Gg, Gg, Gg, Gg, Gg, Gg, Gg, Gg, Gg, Gg, Gg, Gg
Gs^Fds, Gs^Fds, Gs^Fds, Gs^Fds, Gs^Fds, Gs^Fds, Gs^Fds, Gll^Fdf, Gs^Fds, Gs^Fds, Gs^Fds, Gs^Fds, Gs^Fds, Gll^Fmf, Gs^Fds, Gs^Fds, Gs^Fds, Gg, Gg, Gg, Gs^Fds, Gs^Fds, Gg, Gg, Gg, Gg^Eff, Re^Eff, Re^Gvs, Gg^Eff, Gs^Vh, Gg, Gg, Gg, Gg, Gg, Gg, Gg, Gg, Gs, Gg, Gg, Gg, Gg, Gg, Gg, Gg
Gs^Fds, Gs^Fds, Gs^Fds, Gs^Fds, Gs^Fds, Gs^Fds, Gs^Fds, Gs^Fds, Gll^Fdf, Gs^Fds, Gs^Fds, Gs^Fds, Gs^Fds, Gll^Fmf, Gs^Fds, Gg^Ve, Gs^Fds, Gs^Fds, Gs^Fds, Gs^Fds, Gs^Fds, Gg, Gs^Fds, Gg, Gg, Gg, Gg, Gg^Eff, Gg, Gg, Gg, Gg, Gg, Gg, Gg, Gg, Gs, Gg, Gs, Gs, Gs, Gs, Gs, Gg, Gg, Gg
Gs^Fds, Gs^Fds, Gll^Fdf, Gs^Fds, Gs^Fds, Gs^Fds, Gs^Fds, Gll^Fdf, Gs^Fds, Gs^Fds, Gs^Fds, Gs^Fds, Gs^Fds, Gll^Fmf, Gs^Fds, Gs^Fds, Gs^Fds, Gs^Fds, Gs^Fds, Gs^Fds, Gg, Gs^Fds, Gs^Fds, Gs^Fds, Gs^Fds, Gg, Gg, Gg, Gg, Gg, Gg, Gg, Gg, Gg, Gg, Gs, Gs, Gs, Gs, Gs, Co, Gs, Gs, Gs, Gs, Gg
Gs^Fds, Gs^Fds, Gs^Fds, Gll^Fdf, Gs^Fds, Gs^Fds, Gll^Fmf, Gs^Fds, Gs^Fds, Gs^Fds, Gs^Fds, Gs^Fds, Gs^Fds, Gs^Fds, Gs^Fds, Gs^Fds, Gs^Fds, Gs^Fds, Gs^Fds, Gll^Fdf, Gg, Gg, Gs^Fds, Gg, Gs^Fds, Gg, Gg, Gg, Gg, Gg, Gg, Gg, Gg, Gs, Gs, Gs, Co, Co, Gs, Gs, Gs, Gs, Co, Gs, Gs, Gs
Gs^Fds, Gs^Fds, Gs^Fds, Gs^Fds, Gs^Fds, Gs^Fds, Gs^Fds, Gs^Fds, Gs^Fds, Gll^Fdf, Cv, Gs^Fds, Gs^Fds, Gs^Fds, Gs^Fds, Gs^Fds, Gs^Fds, Gs^Fds, Gg^Ve, Gs^Fds, Gs^Fds, Gs^Fds, Gg, Gs^Fds, Gg, Gg, Gg, Gg, Gg, Gg, Gg, Gg, Gs, Gs, Co, Gs, Gs, Gd^Vo, Re, Gs, Gs, Gs, Gd^Vo, Co, Ww, Ww
Gs^Fds, Gs^Fds, Gs^Fds, Gs^Fds, Gs^Fds, Gs^Fds, Gs^Fds, Gs^Fds, Gg, Cv, Rp, Kv, Gg, Gs^Fds, Gs^Fds, Gs^Fds, Gs^Fds, Gs^Fds, Gs^Fds, Gs^Fds, Gs^Fds, Gs^Fds, Gll^Fdf, Gs^Fds, Gll^Fdf, Gg, Gs^Fds, Gg, Gg, Gg, Gg, Gg, Gs, Gs, Gs, Gd, Gs, Re, Gd^Vo, Re, Re, Re, Gs, Gd, Ww, Ww
Gs^Fds, Gs^Fds, Gs^Fds, Gs^Fds, Gs^Fds, Gs^Fds, Cv^Cvw, Cv, Rp, Rp, Cv, Rp, Rp, Cv, Cv^Cvw, Gs^Fds, Gs^Fds, Gs^Fds, Gs^Fds, Gs^Fds, Gs^Fds, Gs^Fds, Ss, Gs^Fds, Gg, Gg, Ss, Ss, Gg, Ss, Ss, Gg, Gs, Co, Gd^Vo, Gs, Re, Re, Co, Co, Re, Gd^Vo, Gs, Ww, Ww, Ww
Gs^Fds, Gs^Fds, Gs^Fds, Gs^Fds, Gs^Fds, Gs^Fds, Cv, Gg^Ve, Rp, Cv, 5 Kv, Cv, Rp, Gg^Ve, Cv, Gs^Fds, Gs^Fds, Gs^Fds, Gs^Fds, Gs^Fds, Gs^Fds, Ss, Gs^Fds, Gs^Fds, Gs^Fds, Gs^Fds, Ww^Vm, Gs^Fds, Gg, Ss, Gs^Fds, Gg, Ds, Co, Ds, Re, Ww, Gs, Co, 3 Ko, Co, Co, Ww, Ww, Ww, Ww
Gs^Fds, Gg^Ve, Gs^Fds, Gs^Fds, Gs^Fds, Gs^Fds, Gg, Gg^Ve, Gg, Cv, Cv, Cv, Rp, Gg^Ve, Gg, Gs^Fds, Gs^Fds, Gs^Fds, Gs^Fds, Ss, Gll^Fmf, Ss, Sm, Gg, Gg, Ss, Gg, Ss, Ss, Gg, Ww, Ss, Ww, Ww, Ww, Ds, Ww, Gs, Ww, Ww, Ww, Ww, Ww, Ww, Ww, Ww
Gs^Fds, Gs^Fds, Gs^Fds, Gs^Fds, Gs^Fds, Gs^Fds, Cv, Gg, Gg, Gg^Fet, Rp, Rp, Gg^Ve, Cv, Gs^Fds, Gs^Fds, Gll^Fmf, Gs^Fds, Gs^Fds, Gs^Fds, Ss, Sm, Gs^Fds, Gs^Fds, Sm, Gg, Ds, Ss, Ss, Ww, Ww, Ww, Ww, Ww, Ww, Ww, Ww, Ww, Ww, Ww, Wo, Wo, Ww, Ww, Gg, Gg
Gs^Fds, Gs^Fds, Gs^Fds, Gs^Fds, Gs^Fds, Gs^Fds, Kv, Gg^Ve, Rp, Rp, Gg, Gg^Ve, Kv, Cv, Gs^Fds, Gs^Fds, Gs^Fds, Gs^Fds, Gs^Fds, Sm, Gll^Fdf, Ss, Gg, Ss, Gs^Fds, Sm, Ss^Bw\r, Ww, Ww, Ww, Ww, Ww, Wwr, Wo, Wo, Ww, Wo, Ww, Ww^Vm, Wo, Wo, Wo, Ww, Ds, Gg, Gg
Gs^Fds, Gs^Fds, Gs^Fds, Gs^Fds, Gs^Fds, Gs^Fds, Rp, Rp, Cv, Gg^Ve, Cv, Cv, Gs^Fds, Gs^Fds, Gs^Fds, Gs^Fds, Ss, Ss, Gs^Fds, Ss, Gs^Fds, Ss, Ww, Gs^Fds, Ss, Ss, Ww, Ww, Ww, Ww, Wo, Ww^Vm, Wwr, Wo, Wo, Wo, Wo, Wo, Wo, Wo, Wo, Ww, Ww, Ds, Ds, Gg
Gs^Fds, Gs^Fds, Gs^Fds, Gs^Fds, Gg, Gg, Rp, Gll^Fdf, Gs^Fds, Gg, Gs^Fds, Gs^Fds, Gs^Fds, Gs^Fds, Gs^Fds, Gs^Fds, Gll^Fdf, Ww^Vm, Sm, Ss, Gg, Ww^Vm, Ww, Ww, Ww, Ww, Ww, Ww, Ww, Ww, Ww, Ww, Ww, Ww^Ewf, Wwr, Wo, Wo, Wo, Wo^Bw/, Wo, Wo, Ww, Ww, Ww, Ds, Gg
Gs^Fds, Gs^Fds, Gs^Fds, Gs^Fds, Rp, Rp, Gg, Gs^Fds, Gs^Fds, Gs^Fds, Gs^Fds, Gs^Fds, Gs^Fds, Gs^Fds, Gs^Fds, Gs^Fds, Gs^Fds, Sm, Ss, Gg, Ds, Gs^Fds, Ww, Ww, Ww, Ww, Ww, Wwr, Wwr, Ww^Vm, Ww, Ww^Bw\, Chw, Wo, Ww, Ww^Ewl, Chw, Gg, Ww^Ewl, Wo, Wo, Wo, Ww, Ww, Ds, Gg
Gs^Fds, Gs^Fds, 1 Gg, Rp, Gg, Gs^Fds, Gs^Fds, Gs^Fds, Gs^Fds, Gs^Fds, Gs^Fds, Gs^Fds, Gs^Fds, Gs^Fds, Ss, Sm, Gs^Fds, Sm, Ss, Ss, Ds, Ww, Ww, Ww, Ww, Wo, Wo, Ww, Ww^Ewl, Ww, Wwr, Ww, Chw, Gg, Wwf, Ww, 2 Kh, Gg, Gg, Wo, Wo, Wo, Ww, Ww, Ww, Ds
Gs^Fds, Gg, Rp, Rp, Gs^Fds, Gs^Fds, Gs^Fds, Gs^Fds, Gs^Fds, Gs^Fds, Gll^Fdf, Gs^Fds, Gs^Fds, Gs^Fds, Gs^Fds, Gg, Gs^Fds, Gs^Fds, Ss, Ds, Ww, Ww, Ww, Wo, Wo, Wo, Wo, Wo, Wo, Wo, Wo, Wo, Gg, Gg, Wwf, Wwf, Ch, Ch, Chw, Wo, Wo, Ww, Ww, Ww, Ww, Ww
Rp, Rp, Gg, Gll^Fmf, Gs^Fds, Gs^Fds, Gs^Fds, Gs^Fds, Gs^Fds, Gs^Fds, Gs^Fds, Gs^Fds, Gs^Fds, Gs^Fds, Gg, Sm, Gs^Fds, Ss, Ds, Ds, Ww, Ww, Ww, Wo, Wo, Wo, Wo, Wo, Wo, Wo, Wo, Ww^Vm, Wo^Bw/, Ch, Ww^Ewf, Wwr, Gg, Ww^Vm, Wo, Wo, Wo, Wo, Ww^Vm, Ww, Ww, Ww
Gg, Gg, Gs^Fds, Gs^Fds, Gs^Fds, Gs^Fds, Gll^Fmf, Gs^Fds, Gs^Fds, Gg^Ve, Gs^Fds, Gs^Fds, Gs^Fds, Gs^Fds, Sm, Ss, Sm, Ds, Ww, Ww, Ww, Ww, Ww, Ww, Wo, Wo, Wo, Wo, Wo, Wo, Wo, Wo, Wo, Wo, Wo, Wo, Wo, Wo^Bw\, Wo, Wo, Wo, Wo, Wo, Ww, Ww, Ww
Gs^Fds, Gs^Fds, Gs^Fds, Gs^Fds, Gs^Fds, Gs^Fds, Gll^Fdf, Gll^Fdf, Gs^Fds, Gs^Fds, Gs^Fds, Gs^Fds, Gll^Fmf, Sm, Ww^Vm, Sm, Ds, Ds, Ww, Ww, Wo, Wo, Wo, Wo, Wo, Wo, Wo, Ww^Vm, Wo, Wo, Wo, Wo, Wo, Wo, Wo, Wo, Wo, Wo, Wo, Wo, Wo, Wo, Wo, Wo, Ww, Ww
Gll^Fmf, Gs^Fds, Gs^Fds, Gs^Fds, Gs^Fds, Gs^Fds, Gs^Fds, Gs^Fds, Gs^Fds, Gs^Fds, Gs^Fds, Gs^Fds, Gs^Fds, Gg, Ss, Ss, Ds, Ww, Ww, Ww, Wo, Wo, Wo, Wo, Wo, Wo, Wo, Wo, Wo, Wo, Wo, Wo, Wo, Wo, Wo, Wo, Wo, Wo, Wo, Wo, Wo, Wo, Wo, Wo, Ww, Ww
