Gg, Gg, Gg^Esd, Gg, Gg, Gg, Gg, Rp, Rp, Gg, Gg, Gg, Gg, Gg, Gg, Gg, Gll, Gll, Gs^Fms, Gs^Fms, Gs^Fms, Gs^Fms, Gs^Fms, Gs^Fms, Gs^Fms, Gs^Fms, Gll, Gs^Fms, Gs^Fms, Gs^Fms, Gs^Fms, Gs^Fms, Gs^Fms, Gll, Gs^Fms, Gs^Fms, Gs^Fms, Gs^Fms, Gs^Fms, Gs^Fms, Gs^Fms, Gs^Fms, Gs^Fms, Gs^Fms, Gs^Fms, Gs^Fms, Gs^Fms, Gs^Fms, Gs^Fms, Gs^Fms, Gs^Fms, Gs^Fms, Gs^Fms, Gs^Fms, Gs^Fms, Gs^Fms, Gs^Fms, Gs^Fms, Gs^Fms, Gs^Fms, Gs^Fms
Gg, Gg, Gg, Gg, Gg, Gg, Gg, Gg, Rp, Gg, Gg, Gg, Gg, Gg, Gg, Gll, Gs^Fms, Gll, Gll, Gll, Gs^Fms, Gs^Fms, Gs^Fms, Gs^Fms, Gs^Fms, Gs^Fms, Gs^Fms, Gs^Fms, Gs^Fms, Gs^Fms, Gs^Fms, Gs^Fms, Gs^Fms, Gs^Fms, Gs^Fms, Gs^Fms, Gll^Fmf, Gs^Fms, Gs^Fms, Gs^Fms, Gs^Fms, Gs^Fms, Gs^Fms, Gs^Fms, Gs^Fms, Gs^Fms, Gs^Fms, Gs^Fms, Gs^Fms, Gs^Fms, Gs^Fms, Gs^Fms, Gs^Fms, Gs^Fms, Gs^Fms, Gs^Fms, Gll^Fmf, Gs^Fms, Gs^Fms, Gs^Fms, Gs^Fms
Gg, Gg, Gg, Gg, Gg, Gg, Gg, Gg, Rp, Gs^Vh, Gg, Gg, Gg, Gg, Gg, Gll, Gll, Gs^Fms, Gs^Fms, Gs^Fms, Gs^Fms, Gs^Fms, Gs^Fms, Gs^Fms, Gs^Fms, Gs^Fms, Gs^Fms, Gs^Fms, Gs^Fms, Gs^Fms, Gs^Fms, Gs^Fms, Gg^Ve, Gs^Fms, Gs^Fms, Gll^Fmf, Gll^Fmf, Gll^Fmf, Gll^Fmf, Gll^Fmf, Gll^Fmf, Gll^Fmf, Gll^Fmf, Gs^Fms, Gs^Fms, Gs^Fms, Gs^Fms, Gs^Fms, Gs^Fms, Gs^Fms, Gs^Fms, Gs^Fms, Gs^Fms, Gs^Fms, Gll^Fmf, Gll^Fmf, Gll^Fdw, Gll^Fmf, Gll^Fmf, Gs^Fms, Gs^Fms
Gg, Gg, Gg, Gg, Gg, Gg, Gg, Gg, Rp, Gg, Gg, Gg, Gg, Gg, Gg, Gg, Gg, Gll, Gs^Fms, Gll, Gs^Fms, Gs^Fms, Gs^Fms, Gs^Fms, Gs^Fms, Gll, Gs^Fms, Gs^Fms, Gll^Fmf, Gs^Fms, Gs^Fms, Gs^Fms, Gs^Fms, Gs^Fms, Gs^Fms, Gs^Fms, Gll^Fmf, Gll^Fdw, Gll^Fdw, Gll^Fdw, Gll^Fdw, Gll^Fdw, Gll^Fmf, Gs^Fms, Gll^Fmf, Gs^Fms, Gs^Fms, Gs^Fms, Gs^Fms, Gg^Ve, Gs^Fms, Gs^Fms, Gll^Fmf, Gll^Fmf, Gll^Fmf, Gll^Fdw, Gll^Fmf, Gll^Fmf, Gll^Fmf, Gll, Gs^Fms
Gg, Gg, Gg, Gg, Gg, Gg, Gg, Gg, Gg, Rp, Gg, Gg, Gg, Gg, Gg, Gg, Gg, Gll, Gs^Fms, Gs^Fms, Gs^Fms, Gs^Fms, Gs^Fms, Gs^Fms, Gll^Fmf, Gs^Fms, Gll^Fmf, Gs^Fms, Gll^Fmf, Gs^Fms, Gll^Fmf, Gs^Fms, Gs^Fms, Gs^Fms, Gll^Fmf, Gll^Fmf, Gll^Fdw, Gll^Fdw, Gll^Fdw, Gll^Fdw, Gll^Fdw, Gll^Fdw, Gll^Fdw, Gll^Fmf, Gll^Fmf, Gs^Fms, Gs^Fms, Gg^Fet, Gs^Fms, Gs^Fms, Gs^Fms, Gll^Fmf, Gll^Fdw, Gll^Fmf, Gll^Fdw, Gll^Fmf, Gll^Fdw, Gll^Fdw, Gll^Fmf, Gll^Fmf, Gs^Fms
Gg, Gg, Gg, Gg, Gg, Gg, Gg, Gg, Gg, Rp, Gg, Gg, Gg, Gg, Gg^Esd, Gg, Gg, Gll, Gll, Gll, Gs^Fms, Gs^Fms, Gs^Fms, Gll^Fmf, Gll^Fdw, Gll^Fmf, Gll^Fdw, Gll^Fmf, Gll^Fdw, Gll^Fmf, Gll^Fmf, Gll^Fmf, Gs^Fms, Gs^Fms, Gs^Fms, Gs^Fms, Gll, Gll^Fdw, Gll^Fdw, Gd^Fetd, Gll^Fdw, Gll^Fdw, Gll^Fmf, Gll^Fdw, Gll^Fmf, Gs^Fms, Gs^Fms, Gs^Fms, Gs^Fms, Gs^Fms, Gll^Fmf, Gll^Fmf, Gll^Fmf, Gll^Fdw, Gll^Fdw, Gll^Fdw, Gll^Fdw, Gll^Fdw, Gll^Fmf, Gll^Fmf, Gs^Fms
Gg, Gg, Gg, Gg, Gg, Gg, Re^Eff, Gg, Gg, Rp, Rp, Gg, Gg, Gg, Re^Eff, Re^Eff, Re^Eff, Gg, Gll, Gll, Gs^Fms, Gs^Fms, Gs^Fms, Gll^Fmf, Gs^Fms, Gll^Fdw, Gd^Fetd, Gll^Fdw, Gll^Fdw, Gll^Fdw, Gll^Fdw, Gs^Fms, Gs^Fms, Gs^Fms, Gs^Fms, Gll^Fmf, Gll^Fmf, Gll^Fdw, Gll^Fdw, Gll^Fdw, Gll^Fdw, Gll^Fdw, Gll^Fdw, Gll^Fdw, Gs^Fms, Gll^Fmf, Gs^Fms, Gs^Fms, Gs^Fms, Gs^Fms, Gll^Fmf, Gll^Fdw, Gll^Fmf, Gll^Fdw, Gll^Fmf, Gll^Fdw, Gll^Fmf, Gll^Fmf, Gs^Fms, Gs^Fms, Gs^Fms
Gg, Gg, Gg, Gg, Re^Eff, Re^Eff, Re^Gvs, Re^Eff, Re^Eff, Gg, Rp, Gg, Re^Eff, Re^Eff, Re^Gvs, Re^Gvs, Re^Gvs, Re^Eff, Re^Eff, Gll, Gs^Fms, Gd^Vhr, Gll^Fmf, Gll^Fdw, Gll^Fmf, Gll^Fdw, Gll^Fdw, Gll^Fdw, Gll^Fdw, Gll^Fdw, Gll^Fmf, Gll^Fmf, Gll^Fmf, Gs^Fms, Gs^Fms, Gs^Fms, Gs^Fms, Gll^Fdw, Gll^Fmf, Gll^Fmf, Gll^Fmf, Gll^Fdw, Gll^Fdw, Gll^Fdw, Gll^Fmf, Gs^Fms, Gs^Fms, Gs^Fms, Gs^Fms, Gs^Fms, Gs^Fms, Gll^Fmf, Gll^Fmf, Gll^Fmf, Gs^Fms, Gll^Fmf, Gll^Fmf, Gs^Fms, Gg^Ve, Gll^Fmf, Gll^Fmf
Gg, Gg, Re^Eff, Re^Eff, Re^Gvs, Re^Gvs, Re^Gvs, Re^Gvs, Re^Gvs, Re^Eff, Gg, Rp, Gs^Vh, Re^Gvs, Re^Gvs, Re^Gvs, Re^Eff, Re^Eff, Gg, Gll, Gs^Fms, Gll, Gs^Fms, Gs^Fms, Gll^Fmf, Gll^Fdw, Gll^Fdw, Gll^Fdw, Gll^Fmf, Gll^Fmf, Gs^Fms, Gs^Fms, Gs^Fms, Gs^Fms, Gs^Fms, Gs^Fms, Gs^Fms, Gll^Fmf, Gll^Fmf, Gll^Fmf, Gs^Fms, Gll^Fmf, Gll^Fmf, Gll^Fmf, Gs^Fms, Gll^Fmf, Gll^Fmf, Gs^Fms, Gll^Fmf, Gs^Fms, Gll^Fmf, Gs^Fms, Gs^Fms, Gs^Fms, Gs^Fms, Gs^Fms, Gll^Fmf, Gll^Fmf, Gll^Fdw, Gll^Fmf, Gs^Fms
Gg, Re^Eff, Re^Eff, Re^Gvs, Re^Gvs, Re^Gvs, Re^Gvs, Re^Gvs, Gg, Gs^Vh, Gg, Rp, Gg, Re^Gvs, Re^Gvs, Re^Gvs, Re^Eff, Re^Eff, Gg, Gll, Gs^Fms, Gll, Gs^Fms, Gs^Fms, Gs^Fms, Gll^Fmf, Gll^Fmf, Gll^Fmf, Gs^Fms, Gs^Fms, Gll, Gs^Fms, Gs^Fms, Gs^Fms, Gs^Fms, Gs^Fms, Gs^Fms, Gs^Fms, Gs^Fms, Gs^Fms, Gs^Fms, Gs^Fms, Gs^Fms, Gs^Fms, Gs^Fms, Gll^Fmf, Gll^Fmf, Gll^Fmf, Gll^Fdw, Gll^Fmf, Gll^Fdw, Gll^Fmf, Gs^Fms, Gs^Fms, Gs^Fms, Gs^Fms, Gll^Fmf, Gll^Fdw, Gll^Fdw, Gll^Fmf, Gll^Fmf
Gg, Gg, Gg, Re^Eff, Re^Eff, Re^Gvs, Gg, Gg, Gg, Gg, Kh, Rp, Kh, Gg, Gg, Re^Eff, Gg, Gg, Gg, Gll, Gll, Gll, Gll, Gll, Gll, Gs^Fms, Gs^Fms, Gll^Fmf, Gs^Fms, Gs^Fms, Gs^Fms, Gs^Fms, Gs^Fms, Gs^Fms, Gs^Fms, Gs^Fms, Gs^Fms, Gs^Fms, Gs^Fms, Gs^Fms, Gs^Fms, Gs^Fms, Gs^Fms, Gs^Fms, Gll^Fmf, Gll^Fmf, Gll^Fmf, Gll^Fdw, Gll, Gll^Fdw, Gll^Fdw, Gll^Fmf, Gs^Fms, Gs^Fms, Gs^Fms, Gll^Fmf, Gll^Fdw, Gll^Fdw, Gll^Fdw, Gll^Fdw, Gll^Fdw
Gg, Gg, Gg, Gg, Gg, Re^Eff, Gg, Gg, Gg, Ch, Gs^Vh, Rp, Gs^Vh, Ch, Rp, Gg, Ch, Gg, Gg, Gg, Gg, Gll, Gll, Gs^Fms, Gs^Fms, Gs^Fms, Gs^Fms, Gs^Fms, Gs^Fms, Gs^Fms, Gs^Fms, Gs^Fms, Gs^Fms, Gs^Fms, Gs^Fms, Gs^Fms, Gll^Fmf, Gg^Ve, Gs^Fms, Gs^Fms, Gs^Fms, Gs^Fms, Gs^Fms, Gs^Fms, Gll^Fmf, Gll^Fmf, Hhd, Hhd^Fdw, Hhd^Fdw, Hhd, Hhd, Gll^Fmf, Gll^Fmf, Gs^Fms, Gll^Fmf, Gll, Gll^Fdw, Gll^Fdw, Gll^Fdw, Gd^Fetd, Gll^Fdw
Gg, Gg, Gg, Gg, Gg, Gg, Ch, Ch, Gs^Vh, Gs, Rp, Rp, Rp, Rp, Ch, Rp, Rp, Ch, Gg, Gg, Gg, Gg, Gll, Gs^Fms, Gs^Fms, Gll, Gs^Fms, Gs^Fms, Gs^Fms, Gg^Fet, Gs^Fms, Gs^Fms, Gs^Fms, Gs^Fms, Gll, Gll^Fmf, Gll^Fdw, Gll^Fmf, Gll^Fmf, Gs^Fms, Gs^Fms, Gs^Fms, Gs^Fms, Gs^Fms, Hh, Gs^Fms, Hhd^Fmf, Hhd, Hhd^Fmf, Hhd, Gll, Hhd, Gs^Fms, Gs^Fms, Gs^Fms, Gs^Fms, Gll^Fmf, Gll^Fdw, Gll^Fdw, Gll^Fdw, Gll^Fdw
Gg, Gg, Gg, Gg, Ch, Gg, Gs^Vh, Gs, Rp, Rp, Gs, Gs^Vh, Rp, Ch, 4 Kh, Ch, Ww, Rp, Gs^Vh, Ch, Gg, Gg, Gg, Gll, Gs^Fms, Gll, Gs^Fms, Gs^Fms, Gs^Fms, Gll, Gs^Fms, Gs^Fms, Gll^Fmf, Gll^Fmf, Gll^Fmf, Gll^Fdw, Gd^Fetd, Gll^Fdw, Gll^Fdw, Gll^Fmf, Gll^Fmf, Gs^Fms, Gs^Fms, Gg^Fet, Gs^Fms, Gs^Fms, Hh^Fms, Hhd^Fmf, Hh, Hh^Fms, Hh^Fms, Gs^Fms, Gll^Fmf, Gs^Fms, Gs^Fms, Gll^Fmf, Gll^Fmf, Gll^Fdw, Gll^Fdw, Gll^Fdw, Gll^Fdw
Gg, Gg, Gg, Ch, Gg, Gg, Rp, Rp, Gg, Gs^Wm, Rp, Rp, Gs, Ch, Ch, Ch, Ww, Rp, Gs, Ch, Gg, Gg, Gg, Gll, Gll, Gs^Fms, Gs^Fms, Gs^Fms, Gs^Fms, Gs^Fms, Gs^Fms, Gs^Fms, Gll^Fmf, Gll^Fdw, Gll^Fmf, Gll^Fdw, Gll^Fdw, Gll^Fdw, Gll^Fdw, Gll^Fdw, Gll^Fmf, Gs^Fms, Gs^Fms, Gs^Fms, Gs^Fms, Gs^Fms, Gs^Fms, Gll, Gll^Fmf, Hh^Fms, Gll^Fmf, Gll^Fmf, Gll^Fmf, Gs^Fms, Gs^Fms, Gs^Fms, Gll^Fmf, Gll^Fdw, Gll^Fdw, Gll^Fdw, Gll^Fdw
Gg, Gg, Gg^Esd, Gg, Gg, Rr^Vhc, Rp, Rr^Vhc, Rr^Vd, Gg, Rp, Gs, Ww, Ww, Ww^Bsb|, Ww, Gs, Rp, Gs, Gs, Ch, Gg, Gg, Gg, Gg, Gll, Gll, Gs^Fms, Gs^Fms, Gs^Fms, Gll, Gs^Fms, Gs^Fms, Gll^Fmf, Gll^Fmf, Gll^Fdw, Gll^Fdw, Gll^Fdw, Gll^Fmf, Gll^Fdw, Gll^Fmf, Gll^Fmf, Gs^Fms, Gs^Fms, Gs^Fms, Gs^Fms, Gs^Fms, Hh^Fms, Gs^Fms, Gll^Fmf, Gll^Fdw, Gll^Fdw, Gll^Fmf, Gll^Fmf, Gs^Fms, Gs^Fms, Gs^Fms, Gll^Fmf, Gll^Fmf, Gll^Fdw, Gll^Fdw
Gg, Gg, Gg, Ch, Rr^Vhc, Rp, Gg, Rp, Rp, Rr, Rp, Ww, Gg, Rr^Vhc, Gg, Gs, Rp, Rp, Rp, Gs^Vh, Kh, Gg, Gg, Gg, Gg, Gg, Gll, Gs^Fms, Gll, Gs^Fms, Gs^Fms, Gs^Fms, Gs^Fms, Gs^Fms, Gll^Fmf, Gll^Fdw, Gll^Fmf, Gll^Fmf, Gs^Fms, Gg, Gs^Fms, Gs^Fms, Gs^Fms, Gll^Fmf, Gs^Fms, Gs^Fms, Gs^Fms, Gs^Fms, Gs^Fms, Gll^Fmf, Gll^Fmf, Gll^Fdw, Gll^Fmf, Gs^Fms, Gs^Fms, Gs^Fms, Gs^Fms, Gs^Fms, Gs^Fms, Gll^Fdw, Gll^Fdw
Gg, Gg, Ww, Ch, Ww^Bw|, Gg, Ww, Rr^Vhc, Gg, Rp, Ww, Ww^Bsb\, Rp, Rp, Gg^Wm, Gs^Vh, Rp, Gs^Vh, Kh, Rp, Rp, Gg, Gg, Gg, Gg, Gg, Gg, Gll, Gs^Fms, Gll, Gs^Fms, Gs^Fms, Gs^Fms, Gs^Fms, Gs^Fms, Gs^Fms, Gs^Fms, Gll^Fmf, Gs^Fms, Gs^Fms, Gs^Fms, Gs^Fms, Gll^Fmf, Gs^Fms, Gll^Fmf, Gll^Fmf, Gs^Fms, Gs^Fms, Gg^Ve, Gs^Fms, Gs^Fms, Gll^Fmf, Gs^Fms, Gll^Fmf, Gll^Fmf, Gll^Fmf, Gll^Fmf, Gll^Fmf, Gll^Fmf, Gll^Fmf, Gll^Fdw
Ww, Ww, Ww, Ww, Ww, Ww, Ww, Ww, Ww^Bw/, Rr^Vhc, Ww, Gg, Rp, Gg, Gs^Vh, Rp, Gs, Ch, Gg, Gg, Gg, Re, Re, Re, Re, Gg, Gg, Gll, Gll, Gs^Fms, Gs^Fms, Gll, Gs^Fms, Gs^Fms, Gs^Fms, Gs^Fms, Gs^Fms, Gs^Fms, Gs^Fms, Gll^Fmf, Gs^Fms, Gll^Fmf, Gll^Fdw, Gll^Fmf, Gll^Fdw, Gll^Fmf, Gll^Fmf, Gs^Fms, Gs^Fms, Gs^Fms, Gs^Fms, Gs^Fms, Gll^Fdw, Gs^Fms, Gs^Fms, Gll^Fdw, Gll^Fdw, Gll^Fdw, Gll^Fdw, Gll^Fmf, Gg
Ww, Ww, Ww, Ww, Ww, Ww, Wo, Ww, Ww, Ww, Ww^Bw/, Rr^Vhc, Gg, Rp, Rp, Rp, Ch, Gg, Gg, Gg, Re, Re, Gg, Gg, Gg, Re, Re, Gg, Gg, Gll, Gll, Gs^Fms, Gs^Fms, Gs^Fms, Gs^Fms, Gs^Fms, Gs^Fms, Gs^Fms, Gs^Fms, Gll^Fmf, Gll^Fmf, Gs^Fms, Gll^Fmf, Gll^Fdw, Gll^Fdw, Gll^Fdw, Gll^Fdw, Gll^Fmf, Gll^Fmf, Gll^Fmf, Gll^Fmf, Gll^Fmf, Gll^Fmf, Gll^Fdw, Gll^Fdw, Gll^Fdw, Gd^Fetd, Gll^Fdw, Gll^Fdw, Gll^Fdw, Gs^Fms
Ww, Ww, Wo, Wo, Wo, Wo, Wo, Wo, Wo, Ww, Ww, Ww, Ww^Bw/, Rr^Vhc, Gg, Ch, Gg, Gg, Gs^Vh, Re, Re^Gvs, Re^Eff, Re^Eff, Gg, Gg, Gg, Gg, Re, Gg, Gg, Gg, Gll, Gll, Gs^Fms, Gll, Gs^Fms, Gd^Vhr, Gs^Fms, Gs^Fms, Gs^Fms, Gs^Fms, Gll^Fmf, Gll^Fmf, Gll^Fmf, Gll^Fmf, Gll^Fdw, Gll^Fmf, Gll^Fmf, Gll^Fmf, Gs^Fms, Gs^Fms, Gs^Fms, Gll^Fmf, Gll^Fdw, Gll^Fdw, Gll^Fdw, Gll^Fdw, Gll^Fdw, Gll^Fdw, Gll^Fdw, Gs^Fms
Ww, Ww, Wo, Wo, Ds, Wo, Wo, Wo, Wo, Ww, Ww, Ww, Ch, Ch, Gg, Gg, Gg, Gg, Re^Gvs, Re^Gvs, Re^Gvs, Re^Gvs, Re^Gvs, Re^Eff, Re^Eff, Gg, Re, Re, Re, Gg, Gg, Gg, Gg, Gll, Gll, Gs^Fms, Gs^Fms, Gll, Gs^Fms, Gs^Fms, Gs^Fms, Gll, Gll, Gs^Fms, Gll^Fmf, Gll^Fmf, Gll^Fmf, Gs^Fms, Gll^Fmf, Gs^Fms, Gs^Fms, Gll^Fmf, Gll^Fdw, Gll^Fmf, Gll, Gll, Gll^Fdw, Gll^Fdw, Gll^Fmf, Gs^Fms, Gs^Fms
Wo, Wo, Wo, Wo, Ds, Gg, Wo, Wo, Wo, Wo, Ww, Ww, Ww, Gg, Gg, Gg, Re^Eff, Re^Gvs, Re^Gvs, Re^Gvs, Re^Gvs, Re^Gvs, Re^Gvs, Re^Gvs, Re^Eff, Re^Eff, Gg, Gg, Gg, Gg, Gg, Gg, Re, Gg, Gll, Gs^Fms, Gs^Fms, Gs^Fms, Gs^Fms, Gg^Fet, Gs^Fms, Gs^Fms, Gs^Fms, Gs^Fms, Gll^Fmf, Gs^Fms, Gll^Fmf, Gll^Fmf, Gd^Fetd, Gll^Fmf, Gll^Fmf, Gll^Fmf, Gll^Fmf, Gll^Fmf, Gll, Gll^Fmf, Gll^Fmf, Gll^Fdw, Gll, Gs^Fms, Gs^Fms
Wo, Wo, Wo, Wo, Wo, Ds, Wo, Wo, Wo, Ww, Ww, Ww, Gg, Gg, Gg, Gg, Gg, Re^Eff, Re^Eff, Re^Gvs, Re^Gvs, Re^Gvs, Re^Eff, Re^Eff, Re, Re, Gg, Gg, Hh^Fds, Hh, Gg, Hh^Vhh, Gg^Esd, Re, Re, Gll, Gll, Gs^Fms, Gs^Fms, Gll, Gs^Fms, Gs^Fms, Gs^Fms, Gs^Fms, Gs^Fms, Gll^Fmf, Gs^Fms, Gll^Fdw, Gll^Fdw, Gll^Fmf, Gll, Gs^Fms, Gll, Gs^Fms, Gll, Gll, Gll, Gll, Gs^Fms, Gll^Fmf, Gll^Fmf
Wo, Wo, Wo, Wo, Wo, Wo, Wo, Wo, Ww, Ww, Ww, Ww, Gg, Gg, Gg, Gg, Gg, Gg, Gg, Re^Eff, Re^Eff, Re^Eff, Re, Re, Gg, Gg, Gg, Gg, Hh^Fds, Hh^Fds, Hh, Hh^Fds, Hh^Fds, Gg, Gg, Re, Gg, Gll, Gll, Gs^Fms, Gll, Gll, Gs^Fms, Gll, Gs^Fms, Gll^Fmf, Gll^Fmf, Gll^Fmf, Gll^Fmf, Gll^Fmf, Gs^Fms, Gs^Fms, Gs^Fms, Gll, Gll, Gll, Gll, Gs^Fms, Gs^Fms, Gll^Fmf, Gs^Fms
Wo, Wo, Wo, Wo, Wo, Wo, Wo, Wo, Ww, Ww, Ww, Gg, Gg, Gg, Gg, Gg, Gg, Gg, Gg, Gg, Re, Re, Gg, Gg, Gg, Gg, Gg, Gg, Hh, Hh, Hh, Hh, Hh^Fds, Hh^Fds, Gg, Gg, Gg, Gg, Gg, Gll, Gll, Gll, Gs^Fms, Gll, Gll, Gs^Fms, Gs^Fms, Gll^Fmf, Gs^Fms, Gs^Fms, Gll^Fmf, Gs^Fms, Gs^Fms, Gs^Vl, Re, Gll, Gs^Fms, Gll, Gll, Gll^Fmf, Gll^Fmf
Wo, Wo, Wo, Wo, Wo, Wo, Wo, Ww, Ww, Ww, Gg, Gg, Gg, Gg, Gg, Gg, Gg, Gg, Gg, Gg, Re, Gg, Gg, Gg, Gg, Gg, Gg, Hh, Hh, Hh^Fds, Hh, Hh, Gg, Gg, Gg, Gg, Gg, Gg, Re, Gg, Gg, Gll, Gll, Gll, Gs^Fms, Gs^Fms, Gs^Fms, Gs^Fms, Gll, Gll^Fmf, Gll^Fdw, Gll^Fmf, Gs^Fms, Gs^Fms, Gg, Gs^Fms, Gs^Fms, Gll^Fmf, Gll^Fmf, Gll^Fmf, Gll^Fdw
Wo, Wo, Wo, Wo, Wo, Wo, Ww, Ww, Ww, Ww, Gg, Gg, Gg, Gg, Gg, Gg, Gg, Gg, Gg, Gg, Re, Gs^Vh, Gg, Gg, Gg, Gg, Hh, Hh, Hh^Fds, Hh, Hh, Hh^Vhh, Gg, Gg, Gg, Gg, Gg, Gg, Gg, Re, Re, Gg, Gg, Gll, Gll, Gll, Gs^Fms, Gs^Fms, Gll, Gs^Fms, Gs^Fms, Gll^Fmf, Gs^Fms, Re, Gs^Fms, Gs^Fms, Gg^Fet, Gs^Fms, Gll^Fmf, Gll^Fdw, Gll^Fmf
Wo, Wo, Wo, Wo, Ww, Ww, Ww, Ww, Ww, Gg, Gg, Gg, Gg, Gg, Re^Eff, Re^Eff, Re^Eff, Gg, Gg, Gg, Gg, Re, Re, Gg, Gg, Gg, Hh^Vhh, Hh, Hh, Hh^Fds, Gg, Gg, Gg, Gg, Gg, Gg, Gg, Gg, Gg, Gg, Gg, Re, Gg, Gg, Gg, Gll, Gll, Gs^Fms, Gs^Fms, Gs^Fms, Gd^Vhr, Gs^Fms, Gs^Fms, Re, Gs^Fms, Gs^Fms, Gs^Fms, Gs^Fms, Gs^Fms, Gll^Fmf, Gs^Fms
Wo, Wo, Ww, Wo, Ww, Ww, Ww, Ww, Ww, Ww, Gg, Gg, Re^Eff, Re^Eff, Re^Gvs, Re^Gvs, Re^Gvs, Re^Eff, Re^Eff, Gg, Gg, Gg, Re, Gg, Gg, Gg, Gg, Gg, Gg, Gg, Gg, Gg, Gg, Gg, Gg, Gg, Gg, Gg, Gg, Gg, Gg, Gg, Gg, Gg^Esd, Gg, Gg, Gll, Gs^Fms, Gll, Gs^Fms, Gs^Fms, Gs^Fms, Gs^Fms, Gll, Gs^Fms, Gs^Fms, Gll^Fmf, Gll^Fmf, Gs^Fms, Gs^Fms, Gs^Fms
Wo, Wo, Ww, Ww, Ww, Ww, Ww, Ww, Gg, Gg, Gg, Re, Gg, Re^Gvs, Re^Gvs, Re^Gvs, Re^Gvs, Re^Gvs, Re^Gvs, Re^Eff, Re^Eff, Gg, Gg, Gg, Gg, Gg, Gg, Gg, Gg, Gg, Gg, Gg, Gg, Gg, Gg, Gg, Gg, Gg, Gg, Gg, Gg, Gg, Gg, Re, Re, Gg, Gg, Gll, Gll, Gs^Fms, Gll, Gs^Fms, Gll, Re, Gs^Fms, Gll, Gll, Gll, Gll, Gs^Fms, Gll
Wo, Wo, Ww, Ww, Ww, Ww, Ww, Ww, Gg, Gg, Gg, Gg, Gg, Gg, Gs^Vh, Re^Gvs, Re^Gvs, Re^Gvs, Re^Eff, Re^Eff, Gg, Gg, Re, Gg, Gg, Gg, Gg, Gg, Gg, Gg, Gg, Gg, Gg, Gg, Gg, Gg, Gg, Gg, Gg, Gg, Gg, Gs^Vh, Gg, Gg, Re, Gg, Gg, Gg, Gg, Gll, Gg, Gll, Re, Re, Gll, Gll, Gs^Fms, Gll^Fmf, Gs^Fms, Gll, Gll
Ww, Ww, Ww, Ww, Ww, Ww, Ww, Gg, Gg, Gg, Gg, Gg, Gg, Gg, Re, Gg, Re^Eff, Re^Eff, Gg, Gg, Gg, Re, Gg, Gg, Gg, Gg, Gg, Gg, Gg, Gg, Gg, Gg, Gg, Gg, Gg, Gg, Gg, Gg, Gg, Gg, Gg, Gg, Gg, Gg, Gg, Re, Gg, Gg, Gg, Gg, Gg, Gg, Gg, Gll, Gg, Gll, Gll, Gll, Gll, Gll, Gg
Ww, Ww, Ww, Ww, Ww, Ww, Gg, Gg, Gg, Gg, Gg, Gg, Gg, Gg, Re, Gg, Gg, Gg, Re, Re, Gg, Gg, Gg, Gg, Gg, Gg, Gg, Gg, Gg, Gg, Gg, Gg, Gg, Gg, Gg, Gg, Gg, Gg, Gg, Gg^Esd, Gg, Gg, Gg, Gg, Gg, Gg, Gg, Re, Re, Re, Gg, Gg, Gg, Gg, Ce, Gg, Gg, Gg, Gg, Gs^Vh, Gg
Ww, Ww, Ww, Ww, Gg, Gg, Gg, Gg, Gg, Gg, Re, Gg, Gg, Gg, Re, Re, Re, Re, Gg, Gg, Gg, Gg, Gg, Gg, Gg, Gg, Gg, Gg, Gg, Gg, Gg, Gg, Gg, Gg, Gg, Gg, Gg, Gg, Gg, Gg, Gg, Gg, Gg, Gg, Gg, Gg, Gg, Gg, Re, Gg, Gg, Gg, Ce, Gg, Gg, Gg, Ce, Gg, Gg, Gg, Gg
Ww, Ww, Ww, Ww, Re^Eff, Re^Eff, Re^Gvs, Gg, Gs^Vh, Re, Gg, Re, Re, Gg^Wm, Re, Re, Re, Gg, Gg, Gg, Gg, Gg, Gg, Gg, Gg, Gg, Gg, Gg, Gg, Gg, Gg, Gg, Gg, Gg, Gg, Gg, Gg, Gg, Gg, Gg, Gg, Gg, Gg, Gg, Gg, Gg, Gg, Gg, Gg, Re, Gg, Gg, Gg, Gg, Re^Vct, Gg, Re^Vct, Gg, Gg, Gg, Gg
Ww, Ww, Ww, Re^Eff, Re^Eff, Re^Gvs, Re^Gvs, Re^Gvs, Re^Gvs, Gg, Gg, Gg, Gg, Re, Gg, Re, Gg, Re, Gs^Vh, Gg, Re^Gvs, Re^Eff, Re^Eff, Gg, Gg, Gg, Gg, Gg, Gg, Gg, Gg, Gs^Vh, Gg, Gg, Gg, Gg, Gg, Gg, Gg, Gg, Gg, Gg, Gg, Gg, Gg, Gg, Gg, Gg, Gg, Re, Gg, Gg, Ce, Ce, Ce, Re^Ecf, Gg, Gg, Gg, Gg, Gg
Ww, Ww, Gg, Re^Eff, Re^Eff, Re^Gvs, Re^Gvs, Re^Gvs, Re^Gvs, Re^Gvs, Re^Eff, Gg, Gg, Gg, Gg, Gg, Gg, Gg, Re^Gvs, Re^Gvs, Re^Gvs, Re^Gvs, Re^Gvs, Re^Eff, Re^Eff, Gg, Gg, Gg, Gg, Gg, Gg, Gg, Gg, Gg, Gg, Gg, Gg, Gg, Gg, Gg, Gg, Gg, Gg, Gg, Gg, Gg, Gg, Gg, Gg, Gg, Re, Gg, Ce, Ke, Ce, 1 Re^Vct, Gg, Ce, Gg, Gg, Gg
Gg, Gg, Gg, Gg, Gg, Re^Eff, Re^Eff, Re^Gvs, Re^Eff, Re^Eff, Gg, Gg, Gg, Gg, Gg, Gg, Re^Eff, Re^Gvs, Re^Gvs, Re^Gvs, Re^Gvs, Re^Gvs, Re^Eff, Re^Eff, Gg^Esd, Gg, Gg, Gg, Gg, Gg, Gg, Gg, Gg, Gg, Gg, Gg, Gg, Gg, Gg, Gg, Gg, Gg, Gg, Gg, Gg, Gg, Gg, Gg, Gg, Gg, Re, Gg, Gg, Ce, Gg, Gg, Gg, Gg, Gg, Gg, Gg
Gg, Gg, Gg, Gg, Gg, Gg, Gg, Re^Eff, Gg, Gg, Gg, Gg, Gg, Gg, Gg, Gg, Gg, Re^Eff, Re^Eff, Re^Gvs, Re^Eff, Re^Eff, Gg, Gg, Gg, Gg, Gg, Gg, Gg, Gg, Gg, Gg, Gg, Gg, Gg, Gg, Gg^Esd, Gg, Gg, Gg, Gg, Gg, Gg, Gg, Gs^Vh, Gg, Gg, Gg, Gg, Gg, Gg, Gg, Gg, Gg, Gg, Ce, Gg, Gg, Gg, Gg, Gg
Gg, Gg, Gg, Gg, Gg, Gg, Gg, Gg, Gg, Gg, Gg, Gg, Gg, Gg, Gg, Gg, Gg, Gg, Gg, Re^Eff, Gg, Gg, Gg, Gg, Gg, Gg, Gg, Gg, Gg, Gg, Gg, Gg, Gg, Gg, Gg, Gg, Gg, Gg, Gg, Gg, Gg, Gg, Gg, Gg, Gg, Gg, Gg, Gg, Gg, Gg, Gg, Re, Gg, Gg^Esd, Gg, Gg, Gg, Gg, Gg, Gg, Gg
