border_size=1
usage=map

Gll^Fdw, Gll^Fdw, Gll^Fdw, Gll^Fdw, Gll^Fdw, Gll^Fdw, Sm, Gll^Fdw, Gll^Fdw, Sm, Gll^Fdw, Sm, Gll^Fdw, Gll^Fdw, Sm, Gll^Fdw, Gll^Fdw, Gll^Fdw, Gll^Fdw, Sm, Sm, Gll^Fdw, Gll^Fdw, Gll^Fdw, Gll^Fdw
Gll^Fdw, Gll^Fdw, Sm, Gll^Fdw, Gll^Fdw, Gll^Fdw, Gll^Fdw, Gll^Fdw, Sm, Gll^Fdw, Sm, Gll^Fdw, Gll^Fdw, Gll^Fdw, Gll^Fdw, Sm, Gll^Fdw, Gll^Fdw, Sm, Gll^Fdw, Gll^Fdw, Gll^Fdw, Gll^Fdw, Gll^Fdw, Gll^Fdw
Gll^Fdw, Gll^Fdw, Sm, Gd^Fetd, Gll^Fdw, Gll^Fdw, Gll^Fdw, Gll^Fdw, Gll^Fdw, Gll^Fdw, Gll^Fdw, Gll^Fdw, Gll^Fdw, Gll^Fdw, Gll^Fdw, Gll^Fdw, Gll^Fdw, Gll^Fdw, Gll^Fdw, Gll^Fdw, Gll^Fdw, Gd^Fetd, Sm, Sm, Gll^Fdw
Gll^Fdw, Sm, Gll^Fdw, Sm, Gll^Fdw, Sm, Gll^Fdw, Sm, Gll^Fdw, Gll^Fdw, Gll, Gll^Fdw, Gll^Fdw, Gll^Fdw, Gll, Gll^Fdw, Gll^Fdw, Gll^Fdw, Sm, Gd^Vhr, Gll^Fdw, Gll^Fdw, Sm, Gll^Fdw, Gll^Fdw
Gll^Fdw, Gll^Fdw, Gll^Fdw, Sm, Gll^Fdw, Gll^Fdw, Sm, Gll^Fdw, Gll^Fdw, Gll, Gll, Gd^Fetd, Gll^Ecf, Gd^Fetd, Gll, Gll, Gll^Fdw, Sm, Gll^Fdw, Gll^Fdw, Gll^Fdw, Gll^Fdw, Gll^Fdw, Gll^Fdw, Gll^Fdw
Gll^Fdw, Gll^Fdw, Gll^Fdw, Gll^Fdw, Gll^Fdw, Gll^Fdw, Sm, Sm, Gll^Fdw, Gll^Fdw, Gd^Fetd, Gll, 3 Gd^Fetd, Gll, Gd^Fetd, Gll^Fdw, Gll^Fdw, Gll^Fdw, Gll^Fdw, Gll^Fdw, Gll^Fdw, Gll^Fdw, Gll^Fdw, Sm, Gll^Fdw
Gll^Fdw, Gll^Fdw, Gll^Fdw, Gll^Fdw, Sm, Gd^Vhr, Gll^Fdw, Gll^Fdw, Gll^Fdw, Gll^Fdw, Gll, Gll^Ecf, Gll, Gll^Ecf, Gll, Sm, Gll^Fdw, Sm, Gll^Fdw, Gll^Fdw, Gll^Fdw, Gll^Fdw, Gll^Fdw, Gll^Fdw, Gll^Fdw
Gll^Fdw, Gll^Fdw, Gd^Fetd, Gll^Fdw, Gll^Fdw, Gll^Fdw, Gll^Fdw, Sm, Gll^Fdw, Gll, Gll, Gd^Fetd, Gll, Gd^Fetd, Gll, Gll, Sm, Sm, Gll^Fdw, Gll^Fdw, Gll^Fdw, Gll^Fdw, Gll^Fdw, Gll^Fdw, Sm
Gll^Fdw, Gll^Fdw, Gll^Fdw, Gll^Fdw, Gll^Fdw, Gll^Fdw, Gll^Fdw, Sm, Gll^Fdw, Gll^Fdw, Gll^Fdw, Gll^Fdw, Gll^Fdw, Gll^Fdw, Gll^Fdw, Gll^Fdw, Gll^Fdw, Gll^Fdw, Gll^Fdw, Gll^Fdw, Gll^Fdw, Sm, Gll^Fdw, Sm, Gll^Fdw
Gll^Fdw, Gll^Fdw, Gll^Fdw, Gll^Fdw, Gll^Fdw, Gll^Fdw, Gll^Fdw, Gll^Fdw, Gll^Fdw, Gll^Fdw, Gll^Fdw, Gll^Fdw, Gll, Gll^Fdw, Gll^Fdw, Sm, Gll^Fdw, Gll^Fdw, Sm, Gll^Fdw, Gll^Fdw, Gll^Fdw, Gll^Fdw, Gll^Fdw, Gll^Fdw
Gll^Fdw, Gll^Fdw, Gll^Fdw, Gll^Fdw, Gll^Fdw, Gll^Fdw, Gll^Fdw, Sm, Gll^Fdw, Sm, Gll^Fdw, Chr, Gll, Chr, Gll^Fdw, Gll^Fdw, Gll^Fdw, Gll^Fdw, Gll^Fdw, Sm, Gll^Fdw, Sm, Gll^Fdw, Gll^Fdw, Gll^Fdw
Sm, Gll^Fdw, Gll^Fdw, Gll^Fdw, Sm, Gll^Fdw, Gll^Fdw, Gd^Fetd, Gll^Fdw, Gll^Fdw, Sm, Gll^Fdw, Gll^Fdw, Gll^Fdw, Gll^Fdw, Gll^Fdw, Gll^Fdw, Gll^Fdw, Sm, Sm, Gll^Fdw, Sm, Gd^Fetd, Gll^Fdw, Gll^Fdw
Gll^Fdw, Sm, Gll^Fdw, Sm, Sm, Gll^Fdw, Gll^Fdw, Gll^Fdw, Sm, Sm, Gll^Fdw, Gll^Fdw, Gll, Sm, Gll^Fdw, Gll^Fdw, Gll^Fdw, Gll^Fdw, Sm, Gll^Fdw, Gll^Fdw, Gll^Fdw, Gll^Fdw, Gll^Fdw, Sm
Gll^Fdw, Gll^Fdw, Gll^Fdw, Gll^Fdw, Gll^Fdw, Gll^Fdw, Gll^Fdw, Gll^Fdw, Gll^Fdw, Gll^Fdw, Gll^Fdw, Gll^Fdw, Gll, Gll^Fdw, Gll^Fdw, Gll^Fdw, Gll^Fdw, Gll^Fdw, Gll^Fdw, Gll^Fdw, Sm, Gll^Fdw, Gll^Fdw, Gll^Fdw, Gll^Fdw
Gll^Fdw, Gll^Fdw, Gll^Fdw, Sm, Gll^Fdw, Sm, Sm, Gll^Fdw, Gll^Fdw, Gll^Fdw, Sm, Gll^Fdw, Gll, Gd^Vhr, Gll^Fdw, Gll^Fdw, Sm, Sm, Sm, Sm, Gll^Fdw, Gll^Fdw, Gll^Fdw, Gll^Fdw, Gll^Fdw
Gll^Fdw, Gll^Fdw, Gll^Fdw, Sm, Gll^Fdw, Gll^Fdw, Gll^Fdw, Gll^Fdw, Gll^Fdw, Gll^Fdw, Gll^Fdw, Gll^Fdw, Gll^Fdw, Gll^Fdw, Sm, Gll^Fdw, Gll^Fdw, Sm, Gll^Fdw, Gll^Fdw, Sm, Gll^Fdw, Gll^Fdw, Gll^Fdw, Gll^Fdw
Gll^Fdw, Gll^Fdw, Sm, Gll^Fdw, Gll^Fdw, Gll^Fdw, Gll^Fdw, Gll^Fdw, Gll^Fdw, Gll^Fdw, Gll^Fdw, Gll, Gll^Fdw, Gll^Fdw, Gll^Fdw, Gll^Fdw, Gll^Fdw, Gll^Fdw, Sm, Gll^Fdw, Gll^Fdw, Gll^Fdw, Gll^Fdw, Sm, Gll^Fdw
Gll^Fdw, Gll^Fdw, Gll^Fdw, Gll^Fdw, Gll^Fdw, Gll^Fdw, Sm, Gll^Fdw, Gll^Fdw, Sm, Gll^Fdw, Gll, Gll^Fdw, Gll^Fdw, Gll^Fdw, Gll^Fdw, Sm, Gll^Fdw, Gd^Fetd, Gll^Fdw, Gll^Fdw, Gll^Fdw, Gll^Fdw, Gll^Fdw, Sm
Sm, Gll^Fdw, Gll^Fdw, Gll^Fdw, Gll^Fdw, Gll^Fdw, Sm, Gll^Fdw, Gll^Fdw, Gll^Fdw, Gll^Fdw, Gll^Fdw, Gll, Gll^Fdw, Gll^Fdw, Gll^Fdw, Gll^Fdw, Sm, Gll^Fdw, Gll^Fdw, Gll^Fdw, Gll^Fdw, Gll^Fdw, Gll^Fdw, Gll^Fdw
Gll^Fdw, Sm, Gll^Fdw, Gll^Fdw, Gd^Fetd, Gll^Fdw, Gll^Fdw, Gll^Fdw, Gll^Fdw, Gll^Fdw, Gll^Fdw, Gll^Fdw, Gll^Fdw, Gll^Fdw, Gll^Fdw, Gll^Fdw, Sm, Sm, Gll^Fdw, Gll^Fdw, Gll^Fdw, Gll^Fdw, Gll^Fdw, Gll^Fdw, Sm
Sm, Sm, Sm, Gll^Fdw, Gll^Fdw, Gll^Fdw, Gll^Fdw, Gll^Fdw, Sm, Gll^Fdw, Gll^Fdw, Gll^Fdw, Gll^Fdw, Gll, Gll^Fdw, Gll^Fdw, Gll^Fdw, Gll^Fdw, Gll^Fdw, Gll^Fdw, Gll^Fdw, Sm, Gll^Fdw, Gll^Fdw, Gll^Fdw
Sm, Sm, Gll^Fdw, Gll^Fdw, Gll^Fdw, Sm, Gll^Fdw, Gll^Fdw, Gll^Fdw, Gll^Fdw, Gll^Fdw, Gll^Fdw, Gll^Fdw, Gll, Gll^Fdw, Gll^Fdw, Gll^Fdw, Sm, Gll^Fdw, Gll^Fdw, Gll^Fdw, Gll^Fdw, Sm, Gll^Fdw, Gll^Fdw
Gll^Fdw, Gll^Fdw, Gll^Fdw, Gll^Fdw, Gll^Fdw, Gll^Fdw, Gll^Fdw, Gll^Fdw, Gll^Fdw, Gll^Fdw, Gll^Fdw, Gll^Fdw, Gll, Gll^Fdw, Gll^Fdw, Gll^Fdw, Gll^Fdw, Gll^Fdw, Gll^Fdw, Sm, Gll^Fdw, Sm, Gd^Fetd, Gll^Fdw, Gll^Fdw
Gll^Fdw, Gll^Fdw, Gll^Fdw, Gll^Fdw, Gll^Fdw, Gll^Fdw, Gll^Fdw, Gll^Fdw, Gll^Fdw, Gll^Fdw, Gll^Fdw, Gll^Fdw, 1 Gll, Gll^Fdw, Gll^Fdw, Gll^Fdw, Gll^Fdw, Gll^Fdw, Gll^Fdw, Sm, Gll^Fdw, Gll^Fdw, Gll^Fdw, Gll^Fdw, Gll^Fdw
Gll^Fdw, Sm, Gll^Fdw, Gll^Fdw, Sm, Gll^Fdw, Gll^Fdw, Gll^Fdw, Gll^Fdw, Gll^Fdw, Gll^Fdw, Gll^Fdw, Gll^Fdw, Sm, Sm, Gll^Fdw, Sm, Gll^Fdw, Gll^Fdw, Gll^Fdw, Gll^Fdw, Gll^Fdw, Gll^Fdw, Gll^Fdw, Gll^Fdw
