border_size=1
usage=map

Gs^Fds, Gs^Fds, Gs^Fds, Gs^Fds, Hh^Fds, Gs^Fds, Hh^Fds, Gs^Fds, Gs^Fds, Gs^Fds, Gs^Fds, Gs^Fds, Hh^Fds, Gs^Fds, Hh^Fds, Gs^Fds, Gs^Fds, Gs^Fds, Gs^Fms, Hh^Fms, Hh^Fms, Gll^Fp, Gll^Fp, Gs^Fds, Gs^Fms, Gs^Fds, Gs^Fms, Gs^Fds, Gs^Fds, Gs^Fds, Gs^Fds, Gs^Fds, Gs^Fds
Wwf^Es, 1 Gs^Fds, 4 Gs^Fds, 5 Hh^Fds, Gs^Fds, Hh^Fds, Hh^Fds, Hh^Fds, Gs^Fds, Hh^Fds, Hh^Fms, Hh^Fms, Hh^Fms, Gs^Fds, Hh^Fms, Gs^Fds, Hh^Fms, Hh^Fms, Hh^Fms, Gs^Fms, Gs^Fms, Gll^Fp, Gs^Fms, Gll^Fp, Gs^Fms, Gs^Fms, Gs^Fms, Gs^Fms, Gs^Fms, Gs^Fms, Gs^Fms, Gs^Fds, Gs^Fms
Wwrg, 2 Wwf^Es, Gs^Fds, Gs, Gs^Fds, Hh^Fds, Hh, Hh^Fds, Hh, Hh, Hh, Hh, Gs^Fds, Hh, Hh, Hh, Hh, Hh, Hh, Gs^Fms, Gll^Fp, Gll^Fp, Gll^Fp, Gs^Fms, Gll^Fp, Gs^Fms, Gll^Fp, Gs^Fms, Gll^Fp, Gs^Fms, Gll^Fp, Gs^Fms, Gs^Fms
Wwg^Es, Wwg^Es, Ww, Gs^Fds, Gs^Fds, Gg^Es, Gg, Gg, Gg, Gg, Gs^Fds, Gs^Fds, Gs^Fds, Hh, Gs, Gg, Gg, Gg, Gg, Gs, Rp^Ve, Gg, Gg, Gs, Gg, Gs^Fms, Gs^Fds, Gll^Fp, Gs^Fms, Gll^Fp, Gll^Fp, Gll^Em, Gs^Fms
Gg, Ww, Ww^Es, Ww, Gs^Fds, Gs, Gs^Fds, Gs, Gs, Gg, Gs^Fds, Gs^Fds, Gs^Fds, Gs^Fds, Gs^Fds, Gg, Gs^Fms, Gg, Gg^Es, Gg, Gg, Rp, Gg, Gg, Rrc, Rrc, Rrc, Rrc, Rrc, Rr^Ve, Rrc, Gll^Fp, Rrc
Gs^Fds, Ww, Ww, Ww, Ww, Gll^Fp, Gll^Fp, Gll^Fp, Gs^Fms, Gll^Fp, Hh^Fms, Gll^Fp, Gs^Fms, Gll^Fp, Gs^Fms, Gll^Fp, Gs^Fms, Gll^Fp, Gs^Fms, Gll^Fp, Gs^Fms, Rp, Rrc, Rrc, Gs^Em, Gs^Fms, Rr^Ve, Gs^Fms, Gs^Fms, Rrc, Gs^Fms, Rrc, Gs^Fds
Gll^Fp, Gs^Fds, Ww, Ww, Ww^Es, Ww, Gs^Fms, Gs^Fms, Hh^Fms, Hh^Fms, Hh^Fms, Gs^Fms, Gs^Fms, Gs^Fms, Gs^Fms, Kv, Gs^Fms, Re^Ve, Gs^Fms, Gll^Fp, Rrc, Rrc, Rp, Gs^Vhs, Gs^Fms, Gs^Fms, Gs^Fms, Gs^Fms, Gll^Fp, Gs^Fms, Gs^Fms, Gs^Fms, Gs^Fds
Gll^Fp, Gs^Fds, Gs^Fds, Ww^Es, Ww, Ww, Ww^Es, Gs^Fds, Hh^Fms, Hh^Fds, Hh, Re^Vhs, Rp, Gs^Fet, Gs^Fms, Cv^Fet, Gs, Re, Re^Vhs, Rrc, Gg, Gs^Fms, Rp^Ve, Rp, Gll^Fp, Gs^Fms, Gs^Fds, Gs^Fms, Gs^Fms, Hh^Fp, Gs^Fms, Gs^Fms, Gs^Fms
Gs^Fms, Hh, Gs^Fds, Ww, Ww^Es, Wo^Es, Wwr, Wwr, Gs^Fds, Hh^Fms, Rp, Rp, Re^Ve, Rp, Rp^Ve, Gs, Gs^Fms, Gs^Fms, Rrc, Rrc, Gs^Fds, Gs^Fms, Gs^Efm, Rp, Rp, Gs^Fms, Gs^Fms, Gs^Fms, Gs^Ve, Gs^Fms, Gs^Fms, Gs^Fms, Gs^Fms
Gs^Fds, Gll^Fp, Gs^Fds, Ww^Es, Ww^Es, Wwr, Wo^Es, Wo^Es, Ww^Es, Ww^Es, Rp, Gs^Fms, Gll^Fp, Rp, Rp, Rp, Rrc, Rrc, Gs^Em, Gs^Fms, Gs^Fms, Gs^Fms, Gs^Fms, Gll^Fp, Gs^Fms, Rr^Ve, Rp, Gg, Gs^Em, Gs^Fms, Gs^Fms, Gs^Fms, Gs^Fms
Gs^Fds, Gs^Fds, Gs^Fms, Hh^Fds, Gs^Fds, Gs^Fds, Ww^Es, Wo^Es, Ww^Bw/, Ww^Bw/, Gs^Fds, Gs^Fms, Gll^Fp, Gll^Fp, Gs^Fms, Gs^Fms, Rrc, Gs, Gs^Fms, Gs^Fms, Gll^Fp, Hh^Fms, Ss, Gs^Fds, Gs^Fms, Gg, Gd, Rp, Gs, Gg^Gvs, Gs^Fms, Gs^Fms, Gs^Fms
Rrc^Ve, Gs^Fds, Gs^Fds, Gs^Fds, Gs^Fds, Gs^Fds, Wwg^Es, Wwr^Bw|, Wo^Es, Wo^Es, Ww^Es, Gs^Fms, Gs^Fms, Gs^Fms, Gs^Fds, Cv^Fet, Ww^Bsb|, Cv^Fet, Ww, Gs^Fms, Gs^Fms, Gll^Fp, Hh^Fms, Gs^Fms, Gs^Ve, Gs, Gs, Gg^Fet, Gd, Kv, Hh^Fms, Gs^Fms, Gs^Fms
Gs^Fds, Hh, Gs^Fms, Hh, Hh^Fms, Ss, Rp, Rp, Ww^Es, Wo^Es, Wwr, Wwr, Cv, Ww, Ww, Ww, Ww^Bsb|, Ww, Ww, Ww, Cv, Gs^Fms, Gs^Fms, Gs^Fms, Gs^Efm, Gs, Gs^Fms, Rp, Rp, Cv^Fet, Hh^Fms, Hh^Fms, Gs^Fms
Gs^Fds, Gd^Fdw, Gs^Fds, Gs^Fds, Gs^Fds, Gs^Fds, Rp, Gs^Fds, Ww^Es, Wwr, Wo^Es, Wo^Es, Ww, Ww, Ww, Cv^Fet, Rrc, Cv^Fet, Ww, Ww, Ww, Gs^Fds, Gs^Fms, Gll^Fp, Gs^Fms, Gs^Fms, Gs^Fms, Gll^Fp, Rp, Gll^Fp, Gs^Fms, Hh^Fms, Gs^Fds
Gll^Fp, Gs^Fds, Cv^Fet, Kv, Gs, Rp, Re^Ve, Gs^Fds, Gs^Fds, Gs^Fds, Ww, Wo, Ww, Ww, Cv, Cv, Rrc, Cv, Cv, Ww, Ww, Ww, Cv, Gs^Fms, Gs^Fms, Gs^Em, Gs^Fds, Gd, Rp^Ve, Gg^Gvs, Gg^Gvs, Gs^Fms, Gs^Fds
Gll^Fp, Gll^Fp, Gs^Fds, Gg, Gs^Fet, Rp, Re^Gvs, Re^Gvs, Re, Cv, Ww, Ww, Cv^Fet, Cv, 3 Kv, Gg^Ve, Rrc, Gg^Ve, Kv, Cv, Cv^Fet, Ww, Ww, Gs^Fms, Gs^Fms, Gs^Fms, Gs^Fp, Gs^Fms, Rp, Gs^Fms, Gs^Fms, Gs^Fms, Gs^Fds
Gs^Fds, Gs^Fds, Gg^Ve, Gs, Rp, Rp, Gs^Vhs, Re^Gvs, Re, Ww, Ww^Es, Ww, Ww^Ewf, Cv, Gg^Ve, Rrc, Gg^Fet, Rrc, Gg^Ve, Cv, Ww^Ewf, Ww, Ww, Ww, Gs^Fms, Ss, Rp, Rp, Gs^Fds, Gs^Fms, Hh^Fms, Gs^Fms, Gs^Fds
Hh, Gs^Fds, Gg^Efm, Rp, Ss, Ss, Gs^Fds, Gs^Fds, Gs^Fds, Ww, Ww, Ww, Ww^Ewf, Gg^Fet, Gg^Ve, Wwr^Bw|, Ww^Ewf, Wwr^Bw|, Gg^Ve, Gg^Fet, Ww^Ewf, Ww, Ww, Ww, Gs^Fms, Gs^Fp, Rp^Ve, Gs^Fms, Gs^Fms, Gs^Fms, Hh^Fms, Hh^Fms, Gs^Fds
Gs^Fds, Gs^Fds, Rp, Rp, Gs^Fds, Ss, Gs^Fds, Gs^Fds, Gs^Fds, Gs^Fds, Ww, Ww, Cv^Fet, Cv, Kv, Rrc, Rrc, Rrc, Kv, Cv, Cv^Fet, Ww, Ww, Cv, Hh^Fds, Gs^Fms, Gs^Fms, Rp, Gll^Fp, Gll^Fp, Gs^Fms, Gs^Fms, Gg^Gvs
Hh^Fms, Hh^Fp, Rp, Gs^Fds, Gs^Fms, Gs^Fds, Gs^Fds, Gs^Fms, Gs^Fds, Gs^Fds, Ww, Ww, Ww, Cv, Cv, Gg^Ve, Rrc, Gg^Ve, Cv, Cv, Ww, Ww, Wwf^Es, Gs^Fds, Gs^Fms, Gll^Fp, Gs^Fms, Rp, Rp, Gs^Fms, Gg^Gvs, Gg^Gvs, Gg^Gvs
Hh^Fp, Re^Gvs, Rp, Gll^Fp, Gs^Fds, Gs^Fds, Gs^Fms, Mm, Gs^Fds, Gs^Fds, Gs^Fds, Cv, Ww, Ww, Ww, Cv, Rrc, Cv, Ww, Ww, Wwf^Es, Cv, Ww, Gs^Fds, Gs^Fms, Gs^Fms, Gs^Fms, Gs^Vhs, Rp, Rp^Ve, Gs^Fms, Gg^Gvs, Gg^Gvs
Re^Gvs, Re^Ve, Rp, Gll^Fp, Gs^Fds, Gs^Fds, Gs^Fds, Gs^Fds, Gs^Fds, Gs^Fds, Gs^Fds, Gs^Fds, Ww, Ww, Ww, Cv^Fet, Ww^Bsb|, Cv^Fet, Ww, Ww, Wwf^Es, Wo^Es, Ww, Wwr, Gs^Fds, Ww^Es, Rp, Rp, Hh^Fp, Gs^Fms, Gs^Fms, Gs^Fms, Gs^Fds
Gs^Fds, Re^Gvs, Gs^Fds, Rp, Rp, Rp, Rp, Gs^Fds, Gs^Fds, Hh^Em, Gs^Fds, Gs^Fds, Gs^Fds, Cv, Ww, Ww, Ww^Bsb|, Ww, Ww, Gs^Fds, Ww^Es, Wwr, Wo, Wo^Es, Wwr, Ww^Es, Wwr^Bw|, Ww^Es, Gs^Fds, Gs^Fms, Gs^Fms, Gs^Fms, Gs^Fds
Hh, Gs^Fms, Hh, Gs^Fds, Gs^Fds, Gs^Fds, Rp, Gs^Vhs, Gs^Fds, Gs^Fds, Hh, Gll^Fp, Rp, Gs^Fds, Gs^Fds, Cv^Fet, Rrc, Cv^Fet, Gs^Fds, Gs^Fds, Gs^Fds, Gs^Fds, Ww^Es, Wwr, Wo, Wo, Wo^Bw|, Wo^Es, Wwr, Ww^Es, Ww, Gs^Fms, Gs^Fds
Gll^Fp, Gs^Fds, Hh^Fds, Hh^Fds, Rp, Rp, Gs^Fds, Rp, Rp, Rp, Rp, Gg^Ve, Re^Gvs, Rp, Rp, Gs^Fds, Rrc, Gs^Fds, Hh^Fds, Hh^Fds, Gs^Fds, Wwf, Gs^Fds, Gs^Vhs, Ww^Bw/, Ww^Bw/, Ww^Es, Wwr, Wo^Es, Wo^Es, Ww, Wwr, Wo^Es
Gs^Fds, Hh^Fds, Gs^Fds, Gs^Fds, Rp, Ss, Gs^Fds, Hh, Gs^Fds, Gll^Fp, Gs^Fds, Re^Gvs, Gs^Fds, Gs^Fds, Gs^Fds, Rrc, Gs^Fds, Rp, Rp, Rp, Rp, Rp, Rp, Rp, Gs^Fds, Gs^Fds, Gs^Fds, Gs^Fms, Gs^Fds, Gs^Vhs, Wwr, Wo, Wo^Es
Gs^Fds, Gs^Fms, Gs^Fds, Gs^Vhs, Gs^Fms, Gs^Fds, Gs^Fds, Gs^Fds, Gs^Fds, Gs^Fds, Gs^Fds, Gs^Fms, Gs^Fms, Gs^Fds, Gs^Fms, Rrc, Gs^Fds, Gs^Fds, Re^Ve, Gs^Fds, Rb, Gs^Fds, Gs^Fms, Gs^Fds, Gs^Fds, Gs^Fds, Gs^Fds, Gs^Fds, Gs^Fms, Gs^Fds, Gs^Fds, Wwr, Wo
Gs^Fds, Gs^Fms, Gs^Fds, Gs^Fds, Gs^Fds, Hh^Fms, Gs^Fds, Hh^Fms, Hh^Fms, Gs^Fds, Gs^Fds, Gs^Fds, Gs^Fds, Gs^Fds, Gs^Fds, Rrc, Gs^Fds, Gs^Fds, Gs^Fds, Gs^Fms, Rb, Gs^Fms, Gs^Fms, Gs^Fms, Gs^Fms, Gs^Fds, Gs^Fds, Gs^Fms, Gs^Fms, Gs^Fds, Gs^Fds, Gs^Fds, Gs^Fds
Gs^Fms, Gs^Fms, Hh^Fms, Hh^Fms, Hh, Hh, Hh^Fms, Hh^Fms, Hh^Fms, Hh^Fms, Gs^Fms, Gs^Fms, Gs^Fms, Gs^Fms, Gs^Fms, Rrc, Gs^Fms, Gs^Fms, Gs^Fms, Gs^Fms, Gs^Fms, Rb, Gs^Fms, Gs^Fms, Gs^Fms, Gs^Fms, Gs^Fds, Gs^Fms, Hh^Fms, Gs^Fms, Gs^Fms, Gs^Fms, Gs^Fms
Gs^Fms, Hh^Fms, Hh^Fds, Hh^Fms, Hh, Hh^Fds, Hh, Hh^Fms, Hh^Fms, Hh^Fms, Gs^Fds, Gs^Fms, Gs^Fms, Gs^Fms, Rrc, Rrc, Gs^Fms, Gs^Fms, Gs^Fds, Gs^Fds, Gs^Fms, Rb, Rb, Gg^Ve, Gs^Fms, Gs^Fms, Gs^Fds, Gs^Fms, Hh^Fds, Hh^Fds, Hh^Fds, Gs^Fms, Gs^Fms
Gs^Fms, Gs^Fms, Hh, Hh, Mm, Mm, Mm, Hh, Hh^Fms, Hh^Fms, Gs^Fms, Gs^Fms, Gs^Fms, Rrc, Gs^Fms, Gs^Fms, Gs^Fms, Gs^Fds, Gs^Fms, Gs^Fms, Gg^Efm, Gg^Efm, Rb, Gs^Fms, Cv^Fet, Gs^Fms, Gs^Fms, Gs^Fds, Hh^Fds, Hh^Fds, Hh^Fms, Hh^Fms, Gs^Fms
Gs^Fms, Gs^Fms, Hh^Fms, Gs^Fms, Hh^Fms, Mm^Vov, Hh, Hh^Fds, Hh^Fms, Hh^Fms, Gs^Fms, Gs^Fms, Rrc, Rrc, Gs^Fds, Gs^Fms, Gg^Gvs, Gg^Gvs, Gg^Gvs, Gs^Fms, Gg^Efm, Gg^Fet, Rb, Kv, Gg^Gvs, Gg^Gvs, Gg^Gvs, Gs^Fds, Gs^Fms, Hh^Fms, Gs^Fds, Hh^Fms, Gs^Fms
Gs^Fms, Hh^Fms, Hh^Fms, Hh^Fds, Hh^Fds, Hh, Hh^Fms, Gs^Fms, Gs^Fms, Gs^Fms, Gs^Fms, Gs^Fms, Rrc, Gs^Fms, Gs^Fms, Gs^Fds, Gs^Fms, Gg^Gvs, Gg^Ve, Rb, Rb, Rb, Gd, Rb, Rb, Gg^Gvs, Gg^Gvs, Gg^Gvs, Gs^Fds, Gs^Fds, Gs^Fds, Gs^Fms, Gs^Fms
Gs^Fms, Gs^Fms, Gs^Fms, Hh^Fms, Hh^Fms, Hh^Fms, Gs^Fms, Hh^Fms, Gs^Fms, Gs^Fms, Gs^Fms, Rrc, Gs^Fms, Gs^Fms, Gs^Fms, Gs^Fms, Gs^Fms, Gs^Fds, Gs^Fms, Gs^Fms, Gs^Fms, Gs, Gs^Fms, Gs^Fms, Gs^Fms, Gg^Ve, Gs^Fms, Gs^Fms, Gs^Fms, Gs^Fds, Gs^Fms, Gs^Fds, Gs^Fms
Gs^Fms, Gs^Fms, Gs^Fms, Hh^Fms, Gs^Fms, Gs^Fms, Gs^Fms, Gs^Fms, Gs^Fms, Gs^Fms, Gs^Fms, Rrc, Gs^Fms, Gs^Fds, Gs^Fds, Gs^Fds, Gs^Fds, Gs^Fms, Gs^Fds, Gs^Fms, Gs^Fms, Gs^Fms, Gs^Fms, Gs^Fms, Gs^Fms, Gs^Fms, Gs^Fms, Gs^Fms, Gs^Fds, Gs^Fds, Gs^Fms, Gs^Fms, Gs^Fms
Gs^Fms, Gs^Fms, Gs^Fms, Gs^Fms, Gs^Fms, Gs^Fms, Gs^Fms, Gs^Fms, Gs^Fms, Gs^Fms, Rrc, Rrc, Gs^Fms, Gs^Fds, Gs^Fms, Gs^Fds, Gs^Fds, Gs^Fds, Gs^Fds, Gs^Fms, Gs^Fms, Gs^Fms, Gs^Fms, Gs^Fms, Gs^Fms, Gs^Fms, Gs^Fms, Gs^Fds, Gs^Fds, Gs^Fds, Gs^Fds, Gs^Fms, Gs^Fms
