Xuc, Xuc, Xuc, Xuc, Xuc, Xuc, Xuc, Xuc, Xuc, Xuc, Xuc, Xuc, Xuc, Uu, Ur, Uu, Xuc, Xuc, Xuc, Xuc, Xuc, Xuc, Xuc, Xuc, Xuc, Xuc, Xuc, Xuc, Xuc, Xuc, Xuc, Xuc, Xuc, Xuc, Xuc, Xuc, Xuc
Xuc, Xuc, Xuc, Xuc, Xuc, Xuc, Xuc, Xuc, Xuc, Xuc, Xuc, Xuc, Xuc, Uu, Ur, Uu, Uu, Uu, Uh, Xuc, Xuc, Xuc, Xuc, Xuc, Uu, Xuc, Uh, Xuc, Uu^Vu, Xuc, Xuc, Uh, Xuc, Xuc, Xuc, Xuc, Xuc
Xuc, Xuc, Xuc, Xuc, Xuc, Xuc, Uu^Vu, Xuc, Tb^Tf, Uu^Vu, Ur, Xuc, Uu, Uu, Xuc, Ur, Uu, Xuc, Xuc, Ur, Uu, Xuc, Xuc, Xuc, Xuc, Uh, Xuc, Uu, Uu, Uu, Uu, Cud, 3 Kud, Xuc, Xuc, Xuc, Xuc
Xuc, Xuc, Uh^Dr, Xuc, Xuc, Xuc, Ur, Uu, Ur, Uu, Xuc, Ur, Uu^Vu, Uu, Uu, Uu, Tb^Tf, Xuc, Xuc, Uu^Vu, Xuc, Ur, Xuc, Xuc, Xuc, Xuc, Uu^Vu, Uu, Ur, Xuc, Uu, Cud, Cud, Xuc, Xuc, Xuc, Xuc
Xuc, Xuc, Xuc, Uu^Br\, Xuc, Xuc, Ur, Xuc, Uu, Uu, Wwg, Xuc, Uh, Xuc, Uu, Xuc, Tb^Tf, Xuc, Uu, Xuc, Ur, Uu, Uu, Xuc, Ur, Xuc, Ur, Ur, Xuc, Uu, Uu, Cud, Uu, Xuc, Xuc, Xuc, Xuc
Xuc, Xuc, Xuc^Efs, Ur, Uu, Uu, Xuc, Uu, Cud, Cud, Uu, Wwg, Uu, Uu, Uu, Ur, Xuc, Uu, Ur, Uu, Uu, Uu, Ur, Uu, Uu, Uu, Uh, Xuc, Xuc, Uu^Vu, Xuc, Xuc, Xuc, Uh, Xuc, Xuc, Xuc
Xuc, Xuc, Uh, Uu^Br|, Xuc, Xuc, Wwg, Uu, 2 Kud, Cud, Xuc, Xuc, Uu, Xuc, Uu, Ur, Uu, Ur, Xuc, Xuc, Xuc, Xuc, Xuc, Xuc, Xuc, Ur, Uh, Xuc, Ur, Xuc, Xuc, Xuc, Xuc, Uh, Xuc, Xuc, Xuc
Xuc, Xuc, Xuc, Uu^Br|, Xuc^Efs, Xuc, Xuc, Wwg, Xuc, Cud, Xuc, Xuc, Uu^Vu, Ur, Xuc, Xuc, Uu, Uh, Uu, Xuc, Xuc, Xuc, Uu, Xuc, Xuc, Xuc, Xuc, Ur, Qxu, Uu, Xuc, Xuc, Xuc, Uu, Uu, Xuc, Xuc
Xuc, Xuc, Xuc, Uu^Br\, Uu, Xuc, Uh, Xuc, Uu, Uh, Xuc, Xuc, Uu, Ur, Xuc, Uh, Ur, Xuc, Xuc, Ur, Uu, Uh, Xuc, Xuc, Qxu, Xuc, Xuc, Qxu, Qxu^Bcx/, Ur, Xuc, Xuc, Xuc, Xuc, Xuc, Xuc, Xuc
Xuc, Xuc, Xuc, Xuc^Efs, Uu, Xuc, Uu, Uh, Xuc, Xuc, Xuc, Uh, Xuc, Xuc, Qxu, Xuc, Ur, Xuc, Xuc, Uu, Ur, Uh, Xuc, Qxu, Qxu, Qxu, Qxu, Ur, Qxu, Qxu, Qxu, Xuc, Qxu, Xuc, Xuc, Xuc, Qxu
Xuc, Xuc, Xuc, Uu^Br/, Xuc^Efs, Xuc, Xuc, Xuc, Xuc, Xuc, Xuc, Uh, Uu, Qxu, Xuc, Uu, Ur, Uu, Qxu, Xuc, Uu, Uu, Qxu, Qxu, Qxu, Qxu, Qxu, Qxu^Bcx|, Qxu, Qxu, Qxu, Qxu, Qxu, Qxu, Qxu, Qxu, Qxu
Xuc, Xuc, Tb^Tf, Uu, Uh, Xuc, Qxua, Qxu, Qxu, Xuc, Qxu, Ur, Qxu^Bh\, Qxu, Qxu, Qxu^Bh|, Qxu, Qxu^Bh\, Uu, Qxu, Qxu^Bh|, Qxu, Qxu, Qxu, Qxu, Qxu, Qxu, Ur, Qxu^Bcx\, Qxu, Qxu, Qxu, Qxu, Qxu, Qxu, Qxu, Qxu
Qxu, Qxe, Tb^Tf, Uu^Br|, Qxua, Ql^Bp\, Uu, Qxua, Qxu, Qxu, Qxu, Qxu, Qxu, Qxu^Bh\, Qxu^Bh\, Qxu^Bh|, Qxu, Qxu, Qxu^Bh|, Qxu, Uu, Qxu, Qxu, Qxu, Qxu, Qxu, Qxu, Qxu, Qxu, Qxu^Bcx\, Ur, Qxu, Xuc, Xuc, Xuc, Qxu, Qxu
Qxu, Qxe, Qxu^Bs|, Uu^Br/, Qxu, Qxua, Ql^Bp|, Qxua, Qxua, Qxu, Qxu, Qxu, Xuc, Qxu, Uu, Uu, Qxu^Bh\, Qxu, Uu, Qxu^Bh/, Qxu, Qxu, Qxu, Qxu, Qxu, Qxu, Qxu, Qxu, Qxu, Qxu, Qxu^Bcx|, Qxu, Qxu, Xuc, Qxu, Qxu, Qxu
Qxu, Qxu, Qxu, Qxu, Qxu, Qxua, Uu, Xuc^Efs, Qxua, Qxu, Qxu, Qxu, Qxu, Qxu, Qxu, Uu, Qxu, Qxu^Bh\, Uu, Qxu, Qxu, Qxu, Qxu, Qxu, Qxu, Qxu, Qxu, Qxu, Qxu, Qxu, Uu, Qxu, Qxu, Qxu, Qxu, Qxu, Qxu
Qxu, Qxu, Qxu, Qxu, Qxu, Qxua, Qxua, Uu, Ql^Bp\, Qxua, Xuc, Qxu, Qxu, Qxu, Qxu, Qxu^Bh|, Qxu, Qxu, Qxu^Bh|, Qxu, Qxu, Xuc, Qxu, Qxu, Qxu, Qxu, Qxu, Qxu, Qxu^Bcx/, Qxu^Bcx/, Xuc, Qxu, Xuc, Xuc, Xuc, Xuc, Xuc
Qxu, Qxu, Qxu^Bs|, Qxu, Qxua, Qxua, Qxua, Qxua, Qxua, Uu, Xuc, Qxu, Xuc, Qxu, Xuc, Qxu^Bh|, Ur, Qxu, Qxu^Bh|, Qxu, Qxu, Qxu, Qxu, Qxu, Xuc, Qxu, Xuc, Uu, Uu, Xuc, Xuc, Xuc, Xuc, Xuc, Xuc, Xuc, Xuc
Qxu, Qxu, Uu^Br|, Qxua, Ql^Bp/, Ql^Bp\, Ql^Bp\, Uu, Ur, Ur, Xuc, Xuc, Xuc, Xuc, Uu^Ii, Uu, Uh, Ur, Uu, Uu, Xuc, Xuc, Xuc, Xuc, Xuc, Qxu, Xuc, Ur, Tb^Tf, Uh, Xuc, Uh^Dr, Xuc, Xuc, Xuc, Xuc, Xuc
Xuc, Qxu, Xuc, Uu^Br\, Uh, Xuc^Efs, Xuc, Xuc, Xuc, Xuc, Xuc, Xuc, Xuc, Xuc, Xuc, Uu, Uu, Uh, Uu, Uu^Ii, Xuc, Xuc, Xuc, Uh, Uh, Xuc, Xuc, Ur, Xuc, Xuc, Xuc, Uh^Edt, Xuc, Xuc, Xuc, Xuc, Xuc
Xuc, Xuc, Xuc, Xuc^Efs, Uu^Br/, Uh, Xuc, Xuc, Xuc, Xuc, Xuc, Xuc, Xuc, Xuc, Xuc, Xuc, Xuc, Ur, Xuc, Xuc, Xuc, Xuc, Uu^Vu, Xuc, Xuc, Uu, Uu, Uu, Xuc, Xuc, Uu, Uu^Edp, Xuc, Xuc, Xuc, Xuc, Xuc
Xuc, Xuc, Tb^Tf, Uu^Br|, Xuc, Xuc, Xuc^Efs, Xuc, Uh^Dr, Xuc, Xuc, Xuc, Uu^Vu, Uh, Xuc, Xuc, Uu^Br/, Ur, Uu, Xuc, Xuc, Uu, Uu, Xuc, Xuc, Uh, Uu, Xuc, Ur, Xuc, Uu, Xuc, Xuc, Xuc, Xuc, Xuc, Xuc
Xuc, Xuc, Xuc, Uu, Xuc, Xuc, Ur, Xuc, Uh, Xuc, Xuc^Efs, Xuc, Xuc, Uu, Ur, Xuc, Uu^Br|, Xuc, Xuc, Uu^Br\, Uu, Ur, Uu, Xuc, Uu, Xuc, Xuc, Ur, Xuc, Uu, Uu, Xuc, Xuc, Xuc, Xuc, Xuc, Xuc
Xuc, Xuc, Xuc, Uu^Br|, Uu^Br/, Uu^Br/, Xuc, Uu, Xuc, Xuc, Uu^Br/, Xuc, Xuc, Uu, Xuc, Uu, Xuc, Xuc, Xuc, Uu, Xuc, Xuc, Xuc, Uu^Br\, Xuc, Uh, Xuc, Xuc, Xuc, Xuc, Ur, Xuc, Xuc, Xuc, Xuc, Xuc, Xuc
Xuc, Xuc, Uh^Dr, Uu^Br/, Uu, Ur, Xuc, Uu^Br|, Uu^Br\, Uu, Xuc, Uu^Br\, Uh, Uu^Br/, Xuc^Efs, Ur, Xuc, Xuc, Xuc, Uh, Ur, Xuc, Xuc, Xuc, Xuc, Uh, Xuc, Xuc, Xuc, Ur, Xuc, Xuc, Xuc, Xuc, Xuc, Xuc, Xuc
Xuc, Xuc, Xuc, Xuc, Xuc, Xuc, Xuc, Xuc, Uu, Xuc, Xuc, Xuc, Uh, Uu, Uu, Ur, Tb^Tfi, Xuc, Xuc, Uh, Ur, Xuc, Uu^Br|, Uu, Ur, Ur, Uu, Xuc, Xuc, Uu, Uu, Ur^Edb, Uu, Xuc, Xuc, Xuc, Xuc
Xuc, Xuc, Uh, Xuc, Xuc, Xuc, Xuc, Xuc, Uh, Xuc, Xuc, Xuc, Xuc, Uu^Br\, Uu, Xuc^Efs, Xuc, Xuc, Xuc, Xuc, Uu, Xuc, Uu^Br/, Xuc, Uh, Xuc, Xuc, Uu^Br\, Uu^Br\, Xuc, Xuc, Xuc, Uu^Edt, Xuc, Xuc, Xuc, Xuc
Xuc, Tb^Tf, Uu, Uh, Xuc, Uu^Vu, Xuc, Ur, Xuc, Uh, Xuc, Xuc, Xuc, Xuc, Tb^Tf, Uu, Uu^Br/, Uu^Br\, Uu, Ur, Xuc, Uu, Uu, Xuc, Xuc, Uh, Xuc, Xuc, Uu, Xuc, Xuc, Uu^Edb, Xuc, Xuc, Xuc, Xuc, Xuc
Xuc, Uu, Uu, Uu, Xuc, Uu, Ur, Uu, Xuc, Uu, Ur, Uh, Ur, Uu, Xuc, Ur, Uu^Emf, Xuc, Xuc, Xuc, Xuc, Ur, Xuc, Xuc, Xuc, Uu, Ur, Xuc, Xuc, Ur, Xuc, Ur^Edt, Xuc, Xuc, Xuc, Xuc, Xuc
Xuc, Uu, Uu^Vu, Xuc, Uh, Uu, Uu, Xuc, Xuc, Xuc, Ur, Xuc, Xuc, Xuc, Xos, Ur, Xos, Xuc, Uu^Emf, Uu^Vu, Xuc, Uh, Uh, Xuc, Xuc, Xuc, Uu, Xuc, Xuc, Uh, Uh, Ur, Xuc, Xuc, Xuc, Xuc, Xuc
Xuc, Uu, Xuc, Xuc, Uh, Xuc, Xuc, Tb^Tf, Xuc, Xuc, Uu, Uu, Xuc, Xuc, Xos, Xos, Xos, Xuc, Xuc, Uu^Emf, Uu^Em, Xuc, Xuc, Ur, Xuc, Uh, Xuc, Uu^Vu, Xuc, Xuc, Xuc, Uu^Br\, Uu^Br\, Xuc, Xuc, Xuc, Xuc
Wog, Uu, Xuc, Xuc, Xuc, Tb^Tf, Xuc, Uu, Xuc, Xuc, Uh, Xuc, Xos, Xos, Iwr, Iwr, Iwr, Xos, Xos, Xuc, Ur, Xuc, Xuc, Uu, Xuc, Uh, Uh, Xuc, Xuc, Xuc, Xuc, Xuc, Xuc, Uh^Dr, Xuc, Xuc, Xuc
Wog, Wog, Wog, Xuc, Xuc, Wwg, Wwg, Tb^Tf, Tb^Tf, Uh, Xuc, Xuc, Xos, Iwr, Iwr^Ii, Iwr^Ii, Iwr^Ii, Iwr, Xos, Xuc, Uh, Ur, Uu, Ur, Uu, Uh, Xuc, Xuc, Xuc, Xuc, Xuc, Xuc, Xuc, Xuc, Xuc, Xuc, Xuc
Xuc, Wog, Xuc, Wog, Wog, Wwg, Xuc, Xuc, Xuc, Xuc, Xuc, Xuc, Xos, Iwr^Ii, Iwr, Iwr^Ii, Iwr, Iwr^Ii, Xos, Xuc, Xuc, Uh, Uh, Xuc, Tb^Tf, Xuc, Xuc, Xuc, Xuc, Xuc, Xuc, Xuc, Xuc, Xuc, Xuc, Xuc, Xuc
Xuc, Xuc, Xuc, Xuc, Xuc, Xuc, Xuc, Xuc, Xuc, Xuc, Xuc, Xuc, Xuc, Xos, Xos, Iwr^Ii, Xos, Xos, Xuc, Xuc, Xuc, Xuc, Xuc, Uh, Xuc, Xuc, Xuc, Xuc, Xuc, Xuc, Xuc, Xuc, Xuc, Xuc, Xuc, Xuc, Xuc
Xuc, Xuc, Xuc, Xuc, Xuc, Xuc, Xuc, Xuc, Xuc, Xuc, Xuc, Xuc, Xos, Xos, Iwr^Ii, Iwr, Iwr, Xos, Xos, Xuc, Xuc, Xuc, Xuc, Xuc, Xuc, Xuc, Xuc, Xuc, Xuc, Xuc, Xuc, Xuc, Xuc, Xuc, Xuc, Xuc, Xuc
Xuc, Xuc, Xuc, Xuc, Xuc, Xuc, Xuc, Xuc, Xuc, Xuc, Xuc, Xos, Iwr, Iwr^Ii, Iwr, Iwr, Iwr, Iwr^Ii, Iwr, Xos, Xuc, Xuc, Xuc, Xuc, Xuc, Xuc, Xuc, Xuc, Xuc, Xuc, Xuc, Xuc, Xuc, Xuc, Xuc, Xuc, Xuc
Xuc, Xuc, Xuc, Xuc, Xuc, Xuc, Xuc, Xuc, Xuc, Xuc, Xuc, Xos, Iwr, Iwr, Iwr^Ii, 1 Iwr^Ii, Iwr^Ii, Iwr, Iwr^Ii, Xos, Xuc, Xuc, Xuc, Xuc, Xuc, Xuc, Xuc, Xuc, Xuc, Xuc, Xuc, Xuc, Xuc, Xuc, Xuc, Xuc, Xuc
Xuc, Xuc, Xuc, Xuc, Xuc, Xuc, Xuc, Xuc, Xuc, Xuc, Xuc, Xos, Xos, Iwr^Ii, Xos, Iwr^Ii, Xos, Iwr, Xos, Xos, Xuc, Xuc, Xuc, Xuc, Xuc, Xuc, Xuc, Xuc, Xuc, Xuc, Xuc, Xuc, Xuc, Xuc, Xuc, Xuc, Xuc
Xuc, Xuc, Xuc, Xuc, Xuc, Xuc, Xuc, Xuc, Xuc, Xuc, Xuc, Xuc, Xuc, Xos, Xuc, Xos, Xuc, Xos, Xuc, Xuc, Xuc, Xuc, Xuc, Xuc, Xuc, Xuc, Xuc, Xuc, Xuc, Xuc, Xuc, Xuc, Xuc, Xuc, Xuc, Xuc, Xuc
