Aa, Aa, Aa, Aa, Aa, Aa, Aa, Aa, Aa, Aa, Aa, Aa, Aa, Aa, Aa, Aa, Aa, Aa, Aa, Aa, Aa, Aa, Aa
Aa, 2 Aa, Aa, Aa, Aa^Fpa, Aa^Fpa, Aa^Fda, Aa^Fpa, Ha, Aa, Ha, Ms, Ms, Aa^Fpa, Aa^Fpa, Aa^Fpa, Aa, Ha, Ha, Aa, Aa, Aa, Aa
Aa^Fpa, Aa, Ha, Aa^Fpa, Aa, Aa, Aa^Voa, Ha, Ha, Ha, Ms, Ha, Ms, Ha, Ms, Aa, Ha, Aa, Ha, Aa, Aa, Aa, Aa
Aa^Fpa, Aa^Fpa, Aa^Fpa, Aa^Fpa, Ha, Ms, Ms, Ha, Ms, Ms, Ms, Ms, Ms, Ms, Ms, Ha^Vhha, Ms, Aa, Aa^Fda, Aa, Aa, Aa, Aa
Aa^Fpa, Aa^Fpa, Aa^Fpa, Aa^Fpa, Aa^Fpa, Aa, Ms, Ms, Ms, Ms, Ms^Xm, Ms, Ms, Ms, Ms, Ms, Ms, Aa^Fpa, Aa^Fda, Aa, Aa, Ha, Aa
Aa, Aa, Aa, Aa, Aa, Ms, Ms, Ms, Ms, Ms, Ms, Ms^Xm, Ms^Xm, Ms^Xm, Ms^Xm, Ms, Ms, Ha, Aa^Fda, Aa^Fda, Aa, Ha, Aa
Aa, Aa, Aa^Fma, Aa^Fda, Ha, Ha, Ms, Ms, Ms^Xm, Ms, Ms^Xm, Ms^Xm, Ms^Xm, Ms^Xm, Ms^Xm, Ms, Ms, Aa^Fma, Aa^Fma, Aa^Fda, Ha, Ha, Aa
Aa, Aa^Fma, Aa^Fma, Aa^Fpa, Ha, Ha, Ms, Ms, Ms, Ms^Xm, Ms^Xm, Ms^Xm, Ms^Xm, Ms^Xm, Ms, Ms^Xm, Ms, Ha, Aa^Fda, Aa, Aa, Aa, Aa
Aa^Fma, Aa^Fma, Aa^Fma, Aa^Fpa, Aa^Fpa, Ms, Ms, Ms, Ms, Ms^Xm, Ms^Xm, Ms^Xm, Ms^Xm, Ms^Xm, Ha, Ms, Ms, Aa^Fda, Aa^Fma, Aa^Fma, Ha, Aa, Aa
Aa, Aa, Aa^Voa, Aa^Fma, Ha, Ms, Ms, Ms, Ha, Ms, Ha, Ms^Xm, Ha, Ha, Ha^Vhha, Ms, Ms, Ms, Aa, Aa^Voa, Ha, Ha, Aa
Aa, Aa, Aa, Aa, Aa, Ms, Ms, Ms, Aa^Fma, Ha, Ha, Aa^Fma, Ha, Aa^Fma, Ha, Ha, Ms, Ms, Aa, Ha, Ha, Aa, Aa
Aa, Aa, Aa, Aa, Ha, Ms, Ms, Ms, Aa, Ha, Ha, Ha, Aa^Fpa, Ha, Aa^Fpa, Aa^Fpa, Ha, Ms, Aa, Aa, Aa, Aa, Aa
Aa, Aa, Aa, Aa, Aa, Ha, Aa, Re, Aa^Fda, Aa^Fda, Aa, 1 Aa^Fpa, Re, Aa^Fpa, Aa, Aa, Aa, Aa, Aa, Aa, Aa, Aa, Aa
Aa, Aa, Aa, Aa, Aa, Aa, Aa, Aa, Aa, Aa, Aa, Aa, Aa, Aa^Fda, Aa^Fda, Aa, Aa^Fda, Ha, Aa, Aa, Aa, Aa, Aa
Aa, Aa, Aa, Aa, Re, Aa, Aa, Aa, Aa, Aa, Aa, Aa, Aa, Aa, Aa, Aa^Fda, Aa, Aa, Aa, Aa, Aa, Aa, Aa
Aa, Aa, Aa, Aa, Aa, Aa, Aa, Aa, Aa, Aa, Aa, Aa, Aa, Aa, Aa, Aa, Aa, Aa, Aa, Aa, Aa, Aa, Aa
Aa, Aa, Aa, Aa, Aa^Vha, Aa, Aa, Aa, Aa, Aa, Ai, Aa^Fpa, Ai, Aa, Aa, Aa, Aa, Aa, Aa, Aa, Aa, Aa^Vla, Aa
Aa, Aa, Aa, Aa, Aa, Aa, Aa, Aa, Aa, Aa^Fpa, Ai, Ai, Ai, Ai, Aa^Fpa, Aa, Aa, Aa, Aa, Aa, Aa, Aa, Aa
Aa, Aa, Aa, Aa, Aa, Aa, Aa, Aa, Aa^Fpa, Ai, Wo, Wo, Ai, Aa^Fpa, Aa, Aa, Aa, Aa, Aa, Aa, Aa, Aa, Aa
Aa, Aa, Aa, Aa, Aa, Aa, Aa, Aa, Aa, Ai, Aa, Ai, Ai, Aa^Fpa, Aa, Aa, Aa, Aa, Aa, Aa, Aa, Aa, Aa
Aa, Aa, Aa, Aa, Aa, Aa, Aa, Aa, Aa, Aa, Aa, Aa^Fpa, Aa^Fpa, Aa, Aa, Aa, Aa, Aa, Aa, Aa, Aa, Aa, Ha
Ha, Ha, Aa, Aa, Aa, Aa, Aa, Aa, Aa, Aa, Aa, Aa, Aa, Aa, Aa, Aa, Aa^Vla, Aa, Aa, Aa, Aa, Ha, Ha
Aa, Ha, Ha, Aa, Aa, Aa, Aa, Aa, Aa, Aa, Aa, Aa, Aa, Aa, Aa, Aa, Aa, Ha, Ha, Ha, Ha, Ha, Aa^Fda
