Ms, Ms, Ms, Ms, Ms, Ms, Ms, Ha, Ms, Ha, Ms, Ms, Ms, Ha, Ha, Aa, Ms, Ms, Ms, Ms, Ms, Ms
Ha, Ms, Ha, Ms, Ms, Ms, Ms, Ms, Ms, Ms, Ms, Ms, Ha, Ms, Ha, Ms, Ms, Ms, Ha, Ms, Ha, Ha
Ha, Ha, Ms, Ha, Ha, Ms, Ha, Ha, Ha, Ha, Ha, Ha, Ha, Ha, Aa^Vla, Ai, Re^Vct, Ms, Ms, Ha, Ms, Ha
Aa, Ha, Aa, Ha, Aa, Ha, Aa^Vla, Aa, Ha, Cea, Cea, 2 Kea, Cea, Cea, Ai, Ai^Bw\r, Re^Ecf, Ha, Aa^Fpa, Cea, Aa^Fpa, Ha
Aa, Aa, Cea, Aa, Aa, Re^Vct, Re^Ecf, Re^Vct, Aa, Aa, Re^Xo, Re^Xo, Aa^Xo, Ai, Aa^Fma, Re^Vct, Re, Aa^Vla, Aa^Fma, Aa^Fpa, Ha, Aa
Aa, Aa, Aa, Aa, Aa^Vla, Aa, Re, Aa, Aa, Re^Xo, Ai, Aa, Wwg, Ai^Xo, Aa, Aa^Fma, Aa^Fma, Re, Aa, Ha, Ha, Aa
Aa, Aa, Cea, Re^Vct, Re^Ecf, Re, Ai, Re, Ai^Bw\r, Ai^Xo, Aa, 1 Ai, Aa^Fpa, Aa^Xo, Re, Re^Vct, Re, Re, Aa^Vla, Cea, Aa^Fma, Aa
Aa, Aa, Aa, Aa, Cea, Ai, Aa, Wwg, Aa, Re^Xo, Re^Xo, Aa, Re^Xo, Re^Xo, Aa, Re^Ecf, Re^Vct, Aa, Cea, Aa^Fpa, Aa^Fpa, Aa
Aa, Aa, Wwg, Aa, Ai, Ai, Cea, Aa, Cea, Cea, Aa, Re^Xo, Aa, Cea, Cea, Aa^Vla, Cea, Aa, Aa, Aa^Fma, Aa, Aa
Aa, Aa, Ai, Ai, Aa, Aa, Aa, Aa, Aa, Aa, Aa, Re, Aa, Aa, Aa, Aa, Aa, Aa, Aa, Aa, Aa, Aa
