Mm, Mm, Mm, Mm, Mm, Mm, Mm, Mm, Mm, Mm, Hh, Hh, Mm, Hh, Hhd, Wwg, Wwg, Gs, Gs, Gd, Gd, Gs, Gd, Gs, Gs, Gs, Gs, Gs, Gs, Gs, Gs, Gs, Gs, Gs, Gd, Gd, Gd
Mm, Mm, Mm, Mm, Mm, Mm, Mm, Mm, Mm, Mm, Hh, Hh, Hhd, Hhd, Gd, Gs, Gs^Fds, Wwg, Gs, Gd, Gd, Gd, Gd, Gd, Gll, Gs, Gs, Gs, Gd, Gd, Gd, Gs, Gs, Gs, Gll, Gd, Gd
Mm, Mm, Mm, Mm, Mm, Mm, Hh, Mm, Mm, Mm, Hh, Gs, Gll^Fdw, Gll^Fdw, Gs^Fms, Gs, Wwg, Wwg, Gs, Gd, Gd, Gd, Gll, Gll, Gs, Gs, Gs, Gs, Gll, Gd, Gd, Gd, Gs, Gs, Gs, Gd, Gs
Mm, Mm, Mm, Mm, Mm, Hh, Mm, Hh, Hh, Gll^Fdf, Gll^Fdw, Gll^Fdw, Gll^Fdw, Gs^Fms, Wwg, Wwg, Gs, Gs, Gd, Gd, Gll, Gll, Gs, Gs, Gs, Gs, Gd, Gd, Gd, Gd, Gd, Gd, Gll, Gll, Hhd, Gs, Hhd
Mm, Mm, Hh, Mm, Hh, Hh, Hh, Gll^Fdw, Hhd, Mm, Gd^Vo, Gll^Fdw, Gll^Fdf, Gs, Wwg, Gs^Fds, Gs, Gd, Gd, Gd, Gs, Gs, Gs, Gs, Gs, Gd, Gd, Gd, Gll, Gd, Gs, Gs, Gs, Gs, Hh, Hhd, Hh
Mm, Mm, Mm, Hh, Gll^Fdf, Mm, Gll^Fdw, Hhd, Gs, Gll^Fdf, Gs, Re, Gll^Fdw, Gll^Fdw, Gs, Wwg, Gs, Gd, Gd, Gd, Gd, Gd, Gd, Gs, Gs, Gd, Gd, Gll, Gs, Gs, Gs, Gs, Gd^Vo, Hhd, Hhd, Hhd, Hh
Mm, Mm, Mm, Hh, Gll^Fdw, Gll^Fdw, Gll^Fdw, Gll^Fdw, Co, Co, Co, Re, Re, Gd^Vo, Gs^Fds, Wwg, Gs, Gd, Gd, Gs, Gd, Gd, Gd, Gs, Gd, Gd, Gll, Gll, Gs, Gd^Vo, Co, Co, Co, Re, Re, Hh, Hh
Hh, Hhd, Hhd, Gll^Fdf, Gll^Fdf, Hhd, Gs, Co, 2 Ko, Co, Gs, Gll^Fdw, Gll^Fdf, Gll^Fdw, Gs, Wwg, Wwg^Bw/r, Gs, Gd, Gd, Gd, Gd, Gll, Gs, Gd, Gd, Gs, Gs, Re, Re, Co, 4 Ko, Co, Hhd, Hh, Gd^Vo, Mm
Hh, Hhd, Gll^Fdf, Gll^Fdf, Gll^Fdf, Gd^Vo, Re, Co, Re, Co, Gll^Fdf, Gs, Gs, Gll^Fdw, Gs, Gs^Fms, Wwg, Gs, Gd, Gd, Gd, Gs, Gd, Gd, Gd, Gll, Gll, Gd^Vo, Re, Gs, Re, Co, Hh, Hh, Mm, Mm, Mm^Xm
Gs, Gs, Gll^Fdf, Gll^Fdf, Gll^Fdw, Gll^Fdw, Re, Co, Gll^Fdf, Re, Gd^Vo, Gs, Gd, Gd, Gs, Wwg, Hh, Hh, Hhd, Gd, Gd, Gd, Gd, Gd, Gd, Gd, Gd, Gs, Gs, Re, Gd^Vo, Hh, Hh, Hh, Mm, Mm, Mm
Gs, Gll, Gd, Gll^Fdw, Gd^Vo, Re, Gll^Fdf, Gs, Gll^Fdw, Gs, Gll^Fdw, Gd, Gd, Gd, Wwg, Wwg, Hh, Hh, Md, Hhd, Hhd, Gd, Gd, Gd, Gd, Gd, Gs, Gs, Gs, Hhd, Hh, Mm, Mm, Mm, Mm, Mm^Xm, Mm^Xm
Gs, Gs, Gll^Fdf, Gll^Fdf, Gll^Fdw, Gll^Fdf, Gll^Fdw, Gs, Gs, Gs, Gs, Gd, Gll, Gs, Wwg, Hh, Wwg, Wwg, Wwg, Hh, Gs, Gd, Gd, Gd, Gd, Gll, Gs, Gs, Gs, Gs, Mm, Hhd, Hh, Mm, Mm, Mm^Xm, Mm^Xm
Gll, Gll, Gll^Fdw, Gd, Gs, Gd, Gs, Gs, Gll, Gll, Gd, Gd, Gd, Gs, Gs, Wwg, Gs, Gs, Gs^Fms, Wwg, Gs, Gd, Gs, Gd, Gd, Gd, Gs, Gs, Gs, Gs, Hhd, Hh, Hh, Mm, Mm, Mm^Xm, Mm^Xm
Gd, Gd, Gd, Gs, Gll, Gll, Gd, Gll, Gd, Gd, Gd, Gd, Gd, Gd, Gd, Gs, Gd, Gs, Wwg^Bw\r, Wwg, Gs, Gs, Gd, Gd, Gd, Gd, Gs, Gs, Gs, Gs, Hh, Hh, Mm, Mm, Mm, Ms^Xm, Ms^Xm
Gd, Gd, Gd, Gs, Gd, Gd, Gd, Gd, Gd, Gd, Gd, Gd, Gd, Gd, Gd, Gd, Gd, Gs, Wwg, Gs, Gs, Gs, Gd, Gd, Gd, Gd, Gs, Gs, Gs, Gs, Gs, Hhd, Mm, Mm, Mm, Ms, Ms
Gs, Gd, Gs, Gd, Gd, Gd, Gd, Gll, Gs, Gs, Gs, Gd, Gd, Gll, Gd, Gd, Gd, Gs^Fds, Wwg, Ww^Vm, Gs, Gd, Gs, Gll, Gs, Gd, Gd, Gd, Gd, Gs, Hh, Hhd, Hhd, Mm, Hh, Ms, Ms
Gd, Gd, Gll, Gd, Gd, Gd, Gd, Gll, Gd, Gs, Gd, Gd, Gll^Fdw, Gd, Gs, Gd, Gll^Fdw, Gs^Fds, Gs^Fds, Wwg, Gs, Gd, Gs, Gs, Gs, Gs, Gs, Gs, Gd, Gd, Gd, Hh, Gs, Hh, Hh, Ha, Ha
Gd, Gd, Gd, Gll, Gs, Gs, Gd, Gd, Gd, Gll^Fdw, Gd, Gll^Fdw, Gd, Gd, Gd^Vo, Gll^Fdw, Gs, Gll^Fdw, Gs, Wwg^Bw/r, Gs^Fds, Gs, Gll^Fdf, Gs, Gs, Gs, Gs, Gs, Gs, Gd, Gd, Gs, Hh, Gs, Gd, Gs, Gs
Gd, Gd, Gd, Gd, Gd, Gs, Gs, Gd, Gd, Gd, Gs, Gd, Gll^Fdw, Gs, Re, Gd, Gll^Fdw, Gs, Gs, Wwg, Wwg, Gll^Fdf, Hh, Gs, Gs, Gs, Hh, Gs, Hh, Hh, Gd, Gd, Gd, Gd, Gs, 1 Gd, Gs
Gd, Gd, Gd, Gd, Gd, Gs, Gs, Gs, Gll^Fdw, Gll^Fdw, Gll^Fdw, Gll^Fdw, Co, Re, Gd, Re, Re, Gll^Fdw, Gll^Fdw, Hhd, Wwg, Hhd, Hh, Gs, Gs, Gs, Hh, Mm, Hh, Hh, Mm, Hh, Hh, Hh, Hh, Hh, Gs
Gd, Gd, Gd, Gd, Gd, Gd, Gd, Gd, Gd^Vo, Gs, Gll^Fdw, Co, 3 Ko, Co, Gll, Gll^Fdf, Gll^Fdf, Gd^Vo, Gll^Fdf, Gs^Fms, Wwg, Gs^Fds, Gll^Fdw, Gs, Hh, Hh, Mm, Hh, Mm, Mm, Mm, Mm, Mm, Mm, Hh, Hh, Ha
Gd, Gd, Gd, Gs, Gd, Gd, Gd, Gd, Gd, Re, Re, Co, Co, Co, Gs, Gll^Fdf, Hhd, Gll^Fdf, Mm^Xm, Mm^Xm, Hhd, Wwg, Gs^Fms, Hh, Mm, Hh, Hh, Hh, Mm, Mm, Mm, Mm, Mm^Xm, Mm, Mm, Ha, Ha
Gd, Gd, Gll, Gll, Gs, Gll^Fdw, Gd, Gd, Gll, Gll^Fdw, Re, Gll^Fdw, Gs, Gll, Gll^Fdf, Gs, Hhd, Hh, Mm^Xm, Mm, Gs^Fms, Wwg, Wog, Mm, Mm, Mm, Mm, Mm, Mm, Mm, Mm^Xm, Mm^Xm, Mm^Xm, Mm^Xm, Ms^Xm, Ms^Xm, Ha
Gd, Gd, Gd, Gd, Gll^Fdw, Gd, Gd, Gll^Fdw, Gd, Gll^Fdw, Gd^Vo, Gll^Fdf, Gll^Fdw, Gll^Fdw, Gll^Fdf, Hhd, Hh, Mm, Hh, Hh, Mm, Mm, Wog, Mm^Xm, Mm^Xm, Mm, Mm, Mm, Mm^Xm, Mm, Mm^Xm, Mm^Xm, Mm^Xm, Mm^Xm, Ms^Xm, Ms^Xm, Ms^Xm
Gd, Gd, Gd, Gd, Gd, Gd, Gd, Gd, Gd, Gll^Fdw, Gll^Fdf, Gll^Fdw, Gll^Fdf, Gll^Fdf, Hh, Hh, Mm, Hh, Mm, Mm, Ms^Xm, Ms^Xm, Ms^Xm, Wog, Wwg, Mm^Xm, Mm^Xm, Mm^Xm, Mm^Xm, Mm^Xm, Mm^Xm, Mm^Xm, Ms, Mm^Xm, Ms^Xm, Ms^Xm, Mm^Xm
