Hh, Hh, Hh^Fp, Gs^Fp, Gs^Fp, Hh, Hh, Gs^Fp, Gg, Gg, Gg, Gg, Gg, Gg, Gg^Efm, Hh^Fp, Hh^Fp, Gs^Fp, Gs^Fp, Hh, Hh, Hh
Hh, Hh, 4 Ke, Ce, Gs^Fp, Hh, Hh, Gg^Efm, Gg, Gg, Gg^Gvs, Gg, Gg^Vh, Gg, Gg, Hh, Hh, Gd, Gd, Hh, Hh, Hh^Fp
Hh, Ce, Ce, Ce, Re, Hh, Gg^Vh, Gg, Gg, Gg^Gvs, Re^Gvs, Re^Gvs, Gg, Gg, Gs, Re^Vct, Ce, Ce, Ce, Gd, Gg, Gs^Fp
Hh, Re^Vct, Re, Re^Vct, Gd, Gs, Gg^Gvs, Gg, Gs, Gg^Efm, Hh, Gs, Hh, Gg, Gs, Gd, Ce, 3 Ke, Ce, Re^Vct, Gg, Gs^Fp
Gs^Fp, Gs^Fp, Re^Vct, Gd, Gs, Gg^Gvs, Gg, Gg, Ww, Hh, Hh, Hh, Gg, Gs, Gg, Gs, Re^Vct, Ce, Gd, Gs, Gg, Gg
Hh, Hh, Gs, Gs, Gg, Gg, Ww, Ww, Kh, Ww, Ww, Gs, Gg, Gg, Gs, Gg, Gg, Gd, Gg, Gs, Gg, Gg
Hh, Hh, Hh, Hh, Ww, Ww, Ch, Ch, Rr^Vhc, Ch, Re, Ww, Ww, Gg, Gg, Gg, Gs, Gg, Gg, Gg, Gg, Gg
Mm, Mm, Hh, Ww, Ch, Gg, Gs, Gg, Rr, Gg, Re, Gg, Ch, Ww, Gg, Gg, Gg^Efm, Gg, Gg, Gg^Efm, Gg, Gg
Hh, Hh, Gg, Ww, Gg, Rr^Vhc, Rr, Rr, Qxe, Rr, Rr, Rr, Gg, Ww, Gg, Gg, Gg^Gvs, Gg, Gg, Gg^Efm, Gs^Fp, Gg^Efm
Gs^Fp, Gg, Gs, Ww, Ch, Gg, Rr, Qxe, 2 Kh, Qxe, Rr, Gg, Ch, Wwg, Hh, Gg^Gvs, Gg^Gvs, Gg^Gvs, Gg, Gg, Gs^Fp, Gs^Fp
Gg, Gg, Gg, Ww, Ch, Gs, Rr, Qxe, Qxe, Qxe, Rr, Gg, Ch, Wwg, Ss, Gg, Ss, Gg^Efm, Gg, Gs^Fp, Ww, Ww
Gg, Gg^Gvs, Gg^Gvs, Ww, Kh, Rr^Vhc, Gg, Rr, Rr, Rr, Gg, Rr^Vhc, Kh, Ss, Ss, Gg, Gs^Fp, Ss, Ww, Ww, Gs^Fp, Gs^Fp
Gg^Efm, Gg, Gg, Ww, Wwg, Ch, Gg, Gs, Rp, Gg, Gg, Ch, Wwg, Ss, Ss, Gs^Fp, Ss, Ww^Bw\r, Gs, Gs^Fp, Gg, Gg
Gg, Gg^Gvs, Hh, Hh, Hh, Wwg, Wwg, Ch, Rp, Ch, Wwg, Wwg, Wwg, Ss, Ss, Ss, Ww, Ww, Gg^Gvs, Gg, Gg, Gg
Hh^Fp, Hh, Hh, Hh, Gg, Gg, Gs, Wwg, Wwg, Wwg, Gs, Gg, Gg, Gg, Ss, Ss, Ww, Gg^Gvs, Gg^Gvs, Gg^Vh, Gg, Gg
Gs^Fp, Hh, Mm, Hh, Gg, Gg, Gg, Gg, Rp, Gg, Rp, Rp, Rp, Gg, Ww, Ww, Gg, Gg^Gvs, Gg, Gg, Hh, Hh
Mm, Mm, Mm, Mm, Hh, Gs, Re^Gvs, Gg, Gg, Gs, Gs, Gg, Gg, Gs, Ww^Bsb\, Gg, Gg, Gg, Gg, Hh, Hh, Hh^Fp
Mm, Mm, Mm, Mm, Hh, Re^Gvs, Re^Gvs, Re^Gvs, Gg, Gg, Gg, Gg, Gg, Gg, Ww, Rp, Rp, Gs, Ce, Gs, Gg, Gg
Mm, Mm, Mm, Gs^Fp, Hh, Hh, Gg^Vh, Hh, Hh, Hh, Gg, Gg, Gg, Ww, Gg, Gg, Gg, Ce, 1 Ke, Ce, Gg, Gg
Mm, Mm, Mm, Mm, Mm, Mm, Mm, Hh, Hh, Gg, Gg, Gg, Ww, Ww, Gg, Gg, Rp, Ce, Gs, Gs, Hh, Hh^Fp
Mm^Xm, Mm^Xm, Mm^Xm, Mm, Mm, Mm, Mm, Hh, Gg, Gg, Ww, Ww, Gg, Gs^Vh, Gg, Gg, Gg, Gg, Gg, Hh, Mm, Mm
Mm^Xm, Mm^Xm, Mm^Xm, Mm, Mm, Mm, Mm, Hh^Fp, Gg, Gg, Ww, Gg, Ww, Gg, Gg, Gg, Rp, Gg, Gg, Hh^Fp, Mm, Mm
