Wo, Wo, Wo, Wo, Wo, Wo, Wo, Wo, Wo, Wo, Wo, Wo, Wo, Wo, Wo, Wo, Wwt, Ds, Hd, Hd, Hd, Hd, Mdd, Mdd, Mdd, Mdd, Mdd, Hd, Mdd, Hd, Mdd, Hd, Hd, Dd, Dd^Esd, Dd, Dd^Esd, Dd, Dd, Dd, Dd^Esd, Dd, Dd^Esd, Dd, Dd^Esd, Dd, Dd^Ftd, Hd, Dd^Ftd, Dd, Dd, Dd, Dd, Dd, Dd, Dd, Dd
Wo, Wo, Wo, Wo, Wo, Wo, Wo, Wo, Wo, Wo, Wo, Wo, Wo, Wo, Wo, Wo, Wwt, Ds, Cme, Dd^Vda, Hd, Mdd, Hd, Hd, Hd, Hd, Mdd, Mdd, Hd, Hd, Hd, Hd, Dd, Dd, Ds, Ds, Ds, Dd^Esd, Ds, Dd, Dd, Dd, Dd, Dd, Hd, Hd, Wwt, Wwt, Hd, Dd^Vda, Dd, Dd, Dd^Edb, Dd^Edb, Dd^Edp, Dd^Edp, Dd
Wo, Wo, Wo, Wo, Wo, Wo, Wo, Wo, Wo, Wo, Wwt, Wo, Wwt, Wo, Cme, Wwt, Wwt, Wwt, Cme, Kme, Hd, Hd, Dd^Do, Mdd, Hd, Hd, Hd, Hd, Dd, Dd^Vda, Dd, Dd, Wwt, Wwt, Wwt, Wwt, Wwt, Ds, Wwt, Ds, Ds, Dd^Vdt, Ds, Dd, Dd, Dd^Ftd, Dd, Wwt, Dd^Ftd, Dd, Dd, Dd^Esd, Dd, Dd^Edb, Dd, Dd^Edp, Dd
Wo, Wo, Wo, Wo, Wo, Wo, Wwrt, Wwrt, Wwrt, Wwt, Wwt, Wwt, Ds, Cme, 4 Kme, Cme, Wwt, Wwt, Wwt, Cme, Dd, Dd, Dd, Gs, Dd, Hd, Dd, Dd, Wwt, Dd^Do, Wwt, Wwt, Km, Wwt, Wwrt, Wwt, Wwt, Wwt, Wwt, Wwf, Wwf, Ds, Ds, Ds, Ds, Dd, Dd, Hd, Dd, Hd, Dd, Dd^Esd, Dd^Dc, Dd^Edp, Dd, Dd, Ds
Wo, Wo, Wo, Wo, Wo, Wo, Wo, Wwrt, Wwt, Wwt, Wwt, Wwt, Ds, Ds, Dd^Vda, Cme, Dd, Wwt, Wwt, Wwt, Wwt, Wwt, Wwt, Wwt, Wwt, Dd, Dd, Wwt, Wwt, Wwt, Wwrt, Cm, Wwt, Cm, Wwt, Wwt, Wwrt, Wwt, Wwf, Wwf, Wwf, Wwt, Wwt, Wwt, Wwt, Ds, Ds, Dd, Dd^Esd, Dd, Dd, Dd, Dd, Dd, Ds, Dd^Vdt, Dd
Wo, Wo, Wo, Wo, Wo, Wo, Wo, Wwrt, Wwt, Wwt, Wwt, Wwt, Dd, Hd, Dd, Dd, Ds, Wwt, Wwt, Wwt, Wwt, Wwt, Wwt, Wwt, Wwt, Wwt, Wwrt, Wwf, Wwf, Wwt, Wwt, Wwt, Ww^Vm, Wwt, Wwt, Wwt, Cm, Wwrt, Wwrt, Wwrt, Wwt, Wwt, Wwt, Wwt, Wwt, Wwrt, Ds^Dr, Ds^Esd, Dd^Esd, Ds, Dd, Dd, Dd, Dd, Gs^Esd, Hd, Dd
Wo, Wo, Wo, Wo, Wo, Wo, Wo, Wwrt, Wwt, Wwt, Dd^Vda, Ds, Mdd, Dd^Do, Gs, Gs, Ds, Wwt, Wwt, Wwt, Wwt, Wwf, Wwf, Wwt, Wwt, Wwt, Wwrt, Cm, Ww^Vm, Wwt, Wwt, Wwrt, Cm, Wwrt, Wwt, Ww^Vm, Wwt, Wwt, Wwt, Wwrt, Ds, Wwt, Wwt, Wwt, Wwt, Wwrt, Wwt, Ds, Ds^Esd, Dd, Wwt, Wwt, Gs, Hd, Mdd, Dd^Do, Mdd^Xm
Wo, Wo, Wo, Wo, Wo, Wo, Wwrt, Wwrt, Wwt, Wwt, Dd, Hd, Mdd, Mdd, Dd, Dd, Dd, Wwt, Wwt, Wwrt, Wwrt, Wwt, Wwt, Wwt, Wwt, Wwt, Wwt, Wwf, Wwf, Wwt, Wwt, Wwrt, Wwt, Wwrt, Wwt, Wwt, Wwf, Wwt, Km, Wwt, Ds, Ds, Wwt, Wwf, Wwf, Wwt, Wwt, Ds, Dd, Ds, Wwt, Wwt, Wwt, Hh, Mdd, Mdd, Mdd^Xm
Wo, Wo, Wo, Wo, Wwrt, Wwrt, Ww^Vm, Wwt, Wwt, Ds, Dd, Mdd, Mdd, Mdd, Mdd, Wwt, Wwt, Ds, Wwt, Wwt, Wwrt, Wwt, Ds, Wwf, Wwf, Wwrt, Wwt, Wot, Wwt, Wwt, Wwt, Wwt, Wwt, Wwt, Wwt, Wot, Wwf, Wwf, Cm, Wwf, Wwt, Wwt, Wwrt, Wwt, Wwf, Wwf, Wwf, Ds, Ds, Ds, Dd^Vda, Gs^Ft, Ds, Hh, Hh, Mdd, Mdd^Xm
Wo, Wo, Wo, Wo, Wo, Wwrt, Wwt, Wwt, Wwt, Ds, Hd, Mdd, Mdd, Hd, Dd, Dd, Dd, Wwt, Wwt, Wwrt, Wwt, Ds, Ds, Wwf, Wwf, Wwf, Ww^Vm, Wwt, Ds, Dd, Cm, Cm, 2 Km, Cm, Cm, Wwt, Wwt, Ww^Vm, Km, Wwt, Wwt, Wwt, Wwt, Wwrt, Wwrt, Wwf, Wwf, Ds, Ds, Gg^Esd, Gg^Esd, Ds, Ds, Dd, Gg, Hh, Hh
Wo, Wo, Wo, Wo, Wo, Wo, Wo, Wwt, Wwt, Ds, Hd, Mdd, Hd, Hd, Dd, Dd^Do, Dd, Wwt, Wwt, Wwrt, Wwt, Wwt, Wwrt, Wwf, Wwrt, Cm, Km, Wwt, Wwt, Ds, Ds, Cm, Gg, Cm, Ds, Ds, Wwt, Wwt, Wwt, Cm, Wwt, Wwt, Wwt, Wwrt, Wwt, Wwt, Wwt, Wwf, Wwf, Ds, Ds, Gg, Ce, Gg, Gg, Gg, Gg
Wo, Wo, Wo, Wo, Wo, Wo, Wwt, Wwt, Gg, Dd, Dd, Dd, Dd, Dd, Gs, Dd^Vdt, Ds, Wwt, Wwf, Wwrt, Wwt, Wwt, Wwrt, Wwrt, Wwrt, Wwt, Cm, Ds, Wwt, Wwt, Dd, Gg, Gg, Gg, Ds, Wwt, Ww^Vm, Wwt, Wwt, Wwt, Wwt, Wwt, Wwt, Wwt, Wwt, Wwt, Wwt, Wwf, Wwf, Ds, Gs, Ce, 1 Ke, Ce, Gs^Ft, Gg, Gs
Wo, Wo, Wo, Wo, Wo, Wwrt, Wwrt, Wwt, Wwt, Gg, Gg, Gg, Wwt, Gs, Gs, Gs, Ds, Ds, Wwt, Wwt, Wwt, Wwt, Wwt, Wwrt, Wwt, Wwt, Wwt, Ww^Vm, Wwt, Wwt, Wwt, Ds, Wwt^Bsb|, Ds, Wwt, Wwt, Wwt, Cm, Wwrt, Wwt, Wwt, Wwt, Wwf, Wwf, Wwf, Wwt, Wwf, Wwf, Ds, Ds, Ds, Ce, Ce, Ce, Gs^Ft, Gs^Ft, Hh
Wo, Wo, Wo, Wo, Wo, Wwrt, Wwt, Wwt, Wwt, Wwt, Gg, Gg, Gs^Ft, Wwt, Wwt, Gg, Gg, Ds, Wwt, Wwt, Wwt, Wwt, Wwt, Wwrt, Wwrt, Wwrt, Wwt, Wwt, Wwt, Wwt, Wwt, Ww^Vm, Wwt^Bsb|, Ww^Vm, Wwt, Wwt, Wwt, Wwrt, Wwrt, Wwrt, Wwrt, Wwf, Wwf, Wwf, Ss^Vm, Wwf, Gg, Gs, Gs, Gs, Gs, Gs^Ft, Gs, Gs, Ss^Vhs, Hh, Hh
Wo, Wo, Wo, Wo, Wo, Wwrt, Wwt, Wwt, Wwt, Wwt, Gg, Gg, Gs^Ft, Gs^Ft, Gg, Wwt, Wwt, Wwt, Ds, Wwt, Wwt, Wwrt, Wwt, Wwt, Wwt, Wwt, Wwt, Wwt, Wwt, Wwt, Wwf, Cm, Wwf^Bsb|, Cm, Wwt, Wwt, Wwt, Wwt, Wwt, Wwf, Wwf, Wwf, Wwf, Wwf, Ss, Ss, Gg^Efm, Gg, Gg, Gg, Hh^Fms, Gs, Hh, Hh, Mm, Mm, Mm
Wo, Wo, Wo, Wo, Wo, Wo, Wo, Wwt, Wwt, Wwt, Gg, Gs^Ft, Gs^Ft, Gs^Ft, Gg, Gg, Wwt, Gg, Ds, Ds, Wwt, Wwt, Wwt, Wwt, Wwrt, Wwrt, Wwrt, Wwrt, Wwf, Wwf, Wwt, Wwt, Wwt^Bsb|, Wwt, Wwt, Wwt, Wwt, Wwt, Wwf, Wwt, Wwt, Wwf, Wwf, Ss, Ss, Gg^Efm, Gg, Gg^Efm, Hh, Hh^Fp, Hh, Hh, Wwt, Hh, Mm, Mm, Mm
Wo, Wo, Wo, Wo, Wo, Wo, Wwt, Wwt, Wwt, Wwt, Gs^Ft, Gs^Ft, Gs^Ft, Gs^Ft, Gs^Ft, Gg, Ss, Gs, Gs, Ds, Wwt, Ww^Vm, Wwt, Wwt, Wwf, Wwrt, Wwt, Wwt, Wwt, Wwf, Ds, Ds, Rrc, Gg, Ds, Wwt, Wwt, Wwf, Wwf, Wwf, Wwf, Wwt, Wwt, Wwt, Wwt, Gg^Efm, Gg, Gg^Vc, Hh, Hh, Wwt, Wwt, Hh, Wwt, Mm, Mm, Mm
Wo, Wo, Wo, Wo, Wwrt, Ww^Vm, Wwt, Wwt, Wwt, Wwt, Gs^Ft, Gg, Gs^Ft, Gs^Ft, Gs^Ft, Ss, Gs^Ft, Gs, Gs^Ft, Gs^Ft, Dd, Wwt, Wwf, Wwt, Wwf, Wwt, Wwt, Wwt, Wwt, Wwf, Wwt, Ds, Gg, Rrc, Wwt, Ds, Wwt, Wwt, Wwt, Wwt, Ds, Wwf, Wwt, Ss, Gg, Wwt, Wwt, Wwt, Wwt, Wwt, Hh, Hh, Hh, Mm, Mm, Mm, Mm
Wo, Wo, Wwrt, Wwrt, Wwrt, Ww^Vm, Wwrt, Wwt, Wwt, Wwt, Ss, Gg, Ss, Gs^Ft, Wwt, Wwt, Gs^Ft, Gs^Ft, Gs^Ft, Gs^Ft, Gg, Gs, Gs^Ft, Wwf, Wwf, Wwrt, Wwf, Wwf, Wwt, Wwt, Wwt, Ds, Cm, Wwt^Bsb|, Cm, Wwt, Wwt, Wwt, Wwt, Ss, Gg, Ds, Gg, Gg, Hh, Hh^Fp, Hh, Gg^Efm, Hh, Hh, Hh^Fp, Hh, Hh, Mm, Mm, Mm, Mm
Wo, Wo, Wwt, Wwt, Wwt, Wwrt, Wwrt, Wwt, Wwt, Ss, Ss, Ss, Ss, Ss, Ss^Vhs, Gg, Ss, Gs, Ss, Ss, Ss, Gs^Ft, Gs^Ft, Gs, Gs, Wwf, Ds, Wwf, Wwt, Wwt, Ds, Wwt, Wwt, Wwt^Bsb|, Wwt, Wwt, Wwt, Wwt, Wwt, Ss, Ss, Hh, Hh, Hh, Hh^Fp, Hh^Fms, Hh, Hh, Hh, Hh^Fp, Hh^Fms, Hh, Mm, Mm, Mm, Hhd^Vhhr, Mm
Wo, Wwt, Wwt, Wwt, Wwt, Wwt, Wwrt, Wwt, Ss, Ss, Gs, Ss, Ss, Gs, Ss, Ss, Gs^Ft, Ss, Ss, Ss, Ss, Gs^Ft, Gs, Gs^Ft, Gs, Gs, Gs, Ds, Dd, Ds, Dd, Ds, Ds, Wwt^Bsb|, Ds, Ds, Ss, Wwt, Wwt, Wwt, Wwt, Ss, Hh, Hh^Fp, Hh, Hh, Wwf, Ww^Vm, Hh, Hh^Fp, Hh, Hh, Hh, Mm, Mm^Xm, Mm, Mm
Wo, Wwt, Wwt, Wwt, Wwt, Wwt, Wwrt, Wwt, Wwt, Ss, Ss, Gs, Ss, Ss, Ss, Ss, Gs^Ft, Ss, Ss, Ss, Ss, Gs, Gs, Gs^Ft, Ss, Ss, Gg, Gg, Gg^Efm, Dd, Gg, Gg, Gg, Rr, Gg, Gg, Ss, Ss, Ss, Ss, Ss, Wwf, Wwf, Gg, Wwt, Gg^Efm, Wwt, Wwf, Wwt, Hh, Hh, Hh, Mm, Mm, Mm, Mm, Mm
Wo, Wo, Wwrt, Wwt, Wwrt, Wwrt, Wwt, Wwt, Ss, Wwt, Wwt, Wwt, Wwt, Ss, Ss, Ss, Ss, Ss, Ss, Gs, Gs, Ss, Ss, Ss, Ss, Ss, Gs^Ft, Gs^Ft, Ss, Ss, Gs^Ft, Gg, Gg, Rr, Gs, Gs^Ft, Gs^Ft, Ss, Ss, Ss^Vhs, Ss, Ss, Gg, Wwt, Gg, Wwt, Gg, Gg, Co, Wwt, Hh, Mm, Mm, Mm, Mm, Mm, Mm^Xm
Wo, Wo, Wwrt, Wwrt, Wwt, Wwrt, Wwt, Ss, Ss, Ss, Wwt, Ss, Ss, Ss, Gs^Ft, Ss, Chs, Ss^Edb, Ss^Edb, Ss^Vhs, Ss, Ss, Ss, Gs^Ft, Ss, Ss, Ss, Ss^Vm, Ss, Gs^Ft, Gs^Ft, Gs, Gs, Rp, Gg, Gs^Ft, Gg, Gg^Efm, Gg^Efm, Ss, Hh, Hh, Gs, Wwt, Gg, Co, Co, Co, Re^Vct, Wwt, Wwt, Mm, Mm^Xm, Mm, Mm, Mm, Mm^Xm
Wo, Wo, Wo, Wo, Wwt, Wwt, Wwt, Wwt, Ss, Ss, Wwt, Ss, Ss, Ss, Ss, Chs, 5 Khw, Ss^Edb, Ss^Edb, Ss^Edb, Ss^Edb, Ss, Ss, Ss, Ss, Ss, Ss, Gg, Gg, Gs^Ft, Gs^Ft, Gs^Ft, Gg, Rp, Gg, Wwt, Wwt, Gg, Gg, Hh^Fp, Gs, Gd, Wwt, Wwt^Bw\, Gs, Co, Re, 3 Ko, Hh, Mm, Mm, Mm, Mm, Mm, Mm^Xm, Mm^Xm, Mm^Xm
Wo, Wo, Wo, Wo, Wwt, Wwt, Wwt, Wwt, Ss, Ss, Gs^Ft, Wwt, Wwt, Wwt, Ss, Ss, Ss, Chs, Ss, Ss, Gs, Gs, Ss, Ss, Wwt, Ww^Vm, Ss, Ss, Gs^Ft, Gg, Gg, Gg, Ss, Gd, Rp, Gs^Ft, Wwt, Wwt, Wwf, Gg, Wwt, Gg, Wwt, Gg, Hhd^Vhhr, Gd, Hh, Hh, Hh^Fp, Mm, Mm, Mm, Ha, Mm, Md, Mm^Xm, Mm^Xm
Wo, Wo, Wwt, Wwt, Wwt, Wwt, Wwt, Ss, Wwt, Wwt, Wwt, Ss, Gs, Gs^Ft, Ss, Ss, Ss, Ss, Ss, Gs^Ft, Ss, Ss, Ss, Ss, Ss, Ss, Gs^Ft, Gs^Ft, Gs^Ft, Gs^Ft, Gg, Gs^Vht, Ss, Gg, Gs, Rp, Gs, Wwf, Hh, Wwt, Wwt, Wwt, Hh, Hh, Mm, Hh^Fp, Mm, Hh^Xo, Mm, Mm, Mm, Mm, Mm^Xm, Mm^Xm, Mm^Xm, Mm^Xm, Mm^Xm
Wo, Wo, Wo, Wwt, Wwt, Wwt, Wwt, Ss, Ss, Wwt, Ss, Ss, Ss, Ss, Wwt, Wwt, Wwt, Ss^Vhs, Ss, Ss, Ss, Ss, Ss, Ss, Ss, Ss, Gs^Ft, Gs^Ft, Gs^Ft, Gs^Ft, Gs^Ft, Gs^Ft, Gs^Ft, Gs^Ft, Gs, Rp, Gd, Gs, Gs, Ss^Vhs, Mm, Gg, Mm, Mm, Mm, Mm, Mm^Xm, Mm, Mm, Mm, Mm^Xm, Mm, Mm^Xm, Mm^Xm, Mm^Xm, Mm^Xm, Mm^Xm
Wo, Wo, Wwt, Wwt, Wwt, Wwt, Wwt, Ss, Ss, Ss, Ss, Ss, Gs^Ft, Ss, Ss, Wwt, Ss, Ss, Ss, Ss, Ss, Gs^Ft, Gs^Ft, Gs^Ft, Gs^Ft, Gs^Ft, Gs^Ft, Gs^Ft, Gs^Ft, Gs^Ft, Gs^Ft, Gs^Ft, Gs^Ft, Gs^Ft, Gs^Ft, Gd, Rp, Gs, Gs^Ft, Mm, Mm, Mm^Xm, Mm, Mm^Xm, Mm, Mm^Xm, Mm^Xm, Mm^Xm, Mm^Xm, Mm^Xm, Mm, Mm^Xm, Mm^Xm, Mm^Xm, Mm^Xm, Mm^Xm, Ms
Ww, Wo, Wo, Wwt, Wwt, Wwt, Wwt, Gg, Gg, Ss, Gg, Gs^Ft, Gs^Ft, Gs^Ft, Gg, Gs^Ft, Gg, Gs^Ft, Gg, Gs^Ft, Gg, Gs^Ft, Gg, Gs^Ft, Gs^Ft, Gs^Ft, Gs^Ft, Gs^Ft, Gs^Ft, Gs^Ft, Gs^Ft, Gs^Ft, Gs^Ft, Gs^Ft, Gg, Gs, Rp, Rp, Gs, Gs^Ft, Hh, Mm, Mm^Xm, Mm^Xm, Mm, Mm^Xm, Mm^Xm, Mm^Xm, Mm, Mm, Mm, Mm, Mm, Mm^Xm, Md, Mm^Xm, Mm^Xm
