Gg, Gg, Gg, Gg, Gg, Gg, Gg, Gg, Gg, Gg, Gg, Gg, Gg, Gg, Re, Gg, Gg, Gg, Gg, Gg, Gg, Gg, Gg, Gg, Gg, Gg, Gg, Gg, Gg, Gg, Gg, Gg, Gg, Gg, Gg, Gg, Gg, Gg, Gg, Gg, Gg, Gg, Gg^Gvs, Gg, Gg, Gg, Gg, Gg, Gg, Gg, Gg, Gg, Gg, Gg, Gg, Gg, Gg, Gg, Gg, Gg, Gg, Gg, Gg, Gg, Gg, Gg, Gg, Gg, Gg
Gg, Gg, Gg, Gg, Gg, Gg, Gg, Gg, Gg, Gg, Gg, Gg, Gg, Gs^Vh, Re, Gg, Gg, Gg, Gg, Gg, Gg, Gg, Gg, Gg, Gg, Gg, Gg, Gg, Gg, Gg, Gg, Gg, Gg^Gvs, Gg, Gg, Gg, Gg, Gg, Gg, Gg, Gg, Gg, Gg, Gg, Gg^Gvs, Gg, Gg^Gvs, Gg, Gg, Gg, Gg^Gvs, Gg, Gg, Gg, Gg, Gg, Gg, Gg, Gg^Gvs, Gg, Gg^Gvs, Gg, Rb, Gg, Gg, Gg, Gg, Gg, Gg
Gg, Gg, Gg, Gg, Gg, Gg, Gg, Gg, Gg, Gg, Gg, Gg, Gg, Gg, Gg, Re, Gg, Gg, Gg, Gg, Gg, Gg, Gg, Gg, Gg, Gs^Fds, Gg, Gg, Gg, Gg, Gg, Gg, Gg, Gg, Gg, Gg, Gg, Gg, Gg, Gg, Gg, Gg, Gg, Gg, Gg, Gg, Gg, Gg, Gg, Gg, Gg, Gg, Gg, Gg, Gg, Gg, Gg^Gvs, Gg^Gvs, Gg^Gvs, Gg^Gvs, Gg^Gvs, Rb, Gg^Gvs, Gs^Vh, Gg, Gg, Gg, Gg, Gg
Gg, Gg, Gg, Gg, Gg, Gg, Gg, Gg, Gg, Gg, Gg, Gg, Gg, Gg, Gg, Re, Re, Gg, Gg, Gg, Gll^Fdf, Gg, Gll^Fdf, Gg, Gg, Gs^Fds, Gg, Gs^Fds, Gg, Gg, Gg, Gg, Gg, Gg, Gg, Gg, Gg, Gs^Fds, Gs^Fds, Gg, Gs^Fds, Gg, Gg, Gg, Gg, Gg, Gg, Gg, Gg, Gg, Gg, Gg, Gg, Gg, Gs^Vh, Gg, Rb, Rb, Rb, Gg^Gvs, Rb, Rb, Gg^Gvs, Gg, Gg, Gg, Gg, Gg, Gg
Gg, Gg, Gg, Gg, Gg, Gg, Gg, Gg, Gg, Gg, Gg, Gg, Gll^Fdf, Gll^Fdf, Gs^Fds, Re, Gs^Fds, Re, Gg, Gg, Gs^Fds, Gs^Fds, Gg, Gs^Fds, Gll^Fdf, Gs^Fds, Gll^Fdf, Gll^Fdf, Gll^Fdf, Gll, Gs^Fds, Gll^Fdf, Gg, Gs^Fds, Gll, Gg, Gs^Fds, Gg, Gll^Fdf, Gg, Gg, Gg, Gs^Fds, Gg, Gll^Fmf, Gll, Gll^Fmf, Gg, Gg, Gg, Gg, Gg, Gg, Gg, Gg, Rb, Gg^Gvs, Gg^Gvs, Gg, Rb, Gg^Wm, Gg^Gvs, Gg^Gvs, Gg^Gvs, Gg, Gg, Gg, Gg, Gg
Gg, Gg, Gg, Gg, Gg, Gg, Gg, Gg, Gg, Gg, Gs^Fds, Gll^Fdf, Gll^Fdf, Gll^Fdf, Ke, Re^Vct, Ke, Re, Gg, Gg, Gs^Fds, Gll, Gs^Fds, Gll, Gs^Fds, Gs^Fds, Gll, Gg, Gg, Gs^Fds, Gs^Fds, Gg, Gs^Fds, Gg, Gs^Fds, Gs^Fds, Gg, Gll^Fdf, Gs^Fds, Gg, Gs^Fds, Gg, Gg, Gg, Gg, Gll^Fdf, Gg, Gg, Gs^Fds, Gg, Gg, Gg, Gg, Gg, Gg, Gg^Gvs, Gg^Gvs, Gg^Gvs, Gg^Gvs, Rb, Rb, Gg^Gvs, Gg, Gg^Gvs, Gg^Gvs, Gg, Gg, Gg, Gg
Gg, Gg, Gg, Gg, Gg, Gg, Gg, Gg, Gg, Gg, Gs^Fds, Gll^Fdf, Gs^Fds, Re^Vct, Ce, Ce, Ce, Re^Vct, Hh, Gg, Gs^Fds, Gg, Gg, Gg, Gg, Gs^Fds, Gs^Fds, Gg, Gg, Gg, Gs^Fds, Gs^Fds, Gs^Fds, Gs^Fds, Gs^Fds, Gll, Gs^Fds, Gs^Fds, Gg, Gll, Gs^Fds, Gs^Fds, Gll^Fdf, Gg, Gs^Fds, Gg, Gg, Gg, Gs^Fds, Gs^Fds, Gg, Gg, Gg, Gg, Gg, Gg, Gg, Gg^Gvs, Gg^Gvs, Gg^Gvs, Gg^Gvs, Rb, Gg, Gg, Gg, Gg, Gg, Gg, Gg
Gg, Gg, Gg, Gg, Gg, Gg, Gg, Gg, Gg, Gg, Gs^Fts, Gs^Fds, Gs^Fds, Ke, Ce, 1 Ke, Ce, Ke, Gs^Fds, Gll^Fdf, Gs^Fds, Gs^Fds, Gg, Gs^Fds, Gg, Gll^Fdf, Gs^Fds, Gs^Fds, Gg^Ve, Gg, Gg, Gs^Fds, Gg, Gg, Gs^Fds, Gs^Fds, Gll^Fdf, Gs^Fds, Gs^Fds, Gs^Fds, Gs^Fds, Gg, Gs^Fds, Gg, Gg, Gs^Fds, Gg, Gs^Fds, Gll^Fdf, Gg, Gs^Fds, Gg, Gg, Gs^Fds, Gg, Gg, Gg, Gg, Gg, Gg, Gg, Rb, Gg, Gg, Gg, Gg, Gg, Gg, Gg
Gg, Gg, Gg, Gs^Vh, Gg, Gg, Gg, Gg, Wwf^Edt, Wwf^Edt, Wwf^Edb, Gll^Fmf, Wwf^Es, Sm^Vm, Ke, Ce, Ke, Re^Vct, Hh, Gll^Fdf, Gll^Fdf, Gll^Fmf, Gll^Fmf, Gg, Gll, Gll, Gs^Fds, Gll^Fmf, Gll^Fdf, Gg, Gs^Fds, Gll^Fdf, Gg, Gs^Fds, Gll^Fdf, Gll^Fdf, Gll^Fmf, Gll^Fmf, Gll^Fdf, Gll^Fdf, Gs^Fds, Gs^Fds, Gg^Ve, Gg, Gs^Fds, Gll^Fmf, Gs^Fds, Gs^Fds, Gg, Gg, Gg, Gg, Gg, Gs^Fds, Gg, Gg, Gg, Gg, Gg, Gg, Gg, Gs^Vh, Gg, Gg, Gg, Gg, Gg, Gg, Gg
Gg, Gg, Gg, Gg, Gg, Gg, Gg, Wwf^Edb, Gs^Fds, Gg, Gs^Fds, Wwf^Em, Gg, Gll^Fdf, Gs^Fds, Re^Vct, Gs^Fds, Gs^Fds, Gll^Fmf, Gs^Fds, Gs^Fds, Gll^Fmf, Gll^Fdf, Gg, Gll^Fdf, Gll^Fdf, Gs^Fds, Gll^Fdf, Gs^Fds, Gs^Fds, Gll^Fdf, Gg, Gg, Gg, Gg, Gs^Fds, Gll^Fmf, Gll^Fdf, Gg, Gs^Fds, Gs^Fds, Gg, Gs^Fds, Gll, Gg, Gll, Gll^Fdf, Gs^Fds, Gg, Gs^Fds, Gg, Gs^Fds, Gs^Fds, Gg, Gs^Fds, Gg, Gs^Fds, Gg, Gg, Gg, Gg, Gg, Gg, Gg, Gg, Gg, Gg, Gg, Gg
Gg, Gg, Gg, Gg, Gg, Gg, Wwf^Edb, Wwf^Es, Gs^Fds, Gg, Gs^Fds, Gs^Fds, Gll^Fmf, Gll^Fdf, Gs^Fds, Re, Gs^Fds, Gll, Gs^Fds, Gll^Fmf, Gll^Fmf, Gs^Fds, Gll^Fmf, Hh, Gll^Fdf, Gg, Gg, Gll^Fdf, Gs^Fds, Gs^Fds, Gs^Fds, Gll^Fmf, Gs^Fds, Gs^Fds, Gll^Fmf, Gs^Fds, Gll^Fdf, Gg, Gs^Fds, Gg, Gg, Gg, Gll^Fmf, Gll, Gs^Fds, Gs^Fds, Gg, Gll, Gg, Gll^Fmf, Gs^Fds, Gll, Gll^Fdf, Gs^Fds, Gg, Gs^Fds, Gg, Gg, Gg, Gg, Gg, Gg, Gg, Gg, Gg, Gg, Gg, Gg, Gg
Gg, Gg, Gg, Gg, Gg^Efm, Gg^Efm, Wwf^Efm, Gs^Fds, Gs^Fds, Gll^Fmf, Gg, Gg, Gll^Fdf, Gll, Re, Re, Re, Gg, Gll^Fdf, Gs^Fds, Gll^Fmf, Gs^Fds, Gll^Fdf, Hh, Gll^Fmf, Gs^Fds, Gll^Fdf, Gll, Gll^Fmf, Gll, Gg, Gs^Fds, Gg, Gs^Fds, Gs^Fds, Gll^Fdf, Gll^Fmf, Gg, Gg, Gs^Fds, Gs^Fds, Gs^Fds, Gs^Fds, Gll^Fdf, Gll, Gll, Gg, Gll, Gll, Gs^Fds, Gg, Gs^Fds, Gs^Fds, Gs^Fds, Gs^Fds, Gg, Gs^Fds, Gg, Gg, Gg, Gg, Gg, Gg, Gg, Gg, Gg, Gg, Gg, Gg
Gg, Gg, Gg^Efm, Gg^Efm, Gg^Efm, Gg^Efm, Wwf^Efm, Gll^Fdf, Gll^Fmf, Gs^Fds, Gs^Fds, Gll^Fdf, Gs^Fds, Re, Gs^Fds, Gs^Fds, Gs^Fds, Re, Re, Gll^Fdf, Hh, Gll^Fdf, Hh, Gll^Fdf, Hh, Gll^Fmf, Gs^Fds, Gll^Fmf, Gg, Gs^Fds, Gs^Fds, Gg, Gll^Fdf, Gll, Gs^Fds, Gll^Fmf, Gll^Fdf, Gs^Fds, Gll, Gs^Fds, Gll^Fmf, Gs^Fds, Gll, Gg, Gll^Fmf, Gs^Fds, Gll, Gll^Fdf, Gg, Gg, Gll^Fdf, Gs^Fds, Gll, Gg, Gg, Gg, Gg, Gll^Fdf, Gg, Gg, Gg, Gg, Gg, Gg, Gg, Gg, Gg, Gg, Gg
Gg, Gg, Gg^Efm, Gg^Efm, Gg^Efm, Gg^Efm, Wwf^Efm, Gll^Fdf, Gs^Fds, Gg, Gg, Gs^Fds, Gg, Gs^Fds, Gll, Gg, Gg, Gll^Fmf, Re, Gg^Es, Hh, Gs^Fds, Gs^Fds, Gll^Fdf, Gll^Fdf, Gll^Fmf, Gs^Fds, Gs^Fds, Gg, Gs^Fds, Gg, Gll^Fdf, Gll, Gll^Fmf, Gll^Fdf, Gs^Fds, Gg, Gll, Gg, Gs^Fds, Gs^Fds, Gs^Fds, Gs^Fds, Gll^Fmf, Gll^Fdf, Gs^Fds, Gll, Gg, Gs^Fds, Gg, Gs^Fds, Gs^Fds, Gll^Fdf, Gs^Fds, Gg, Gll^Fdf, Gs^Fds, Gll^Fdf, Gs^Fds, Gs^Fds, Gs^Fds, Gs^Fds, Gg, Gg, Gg, Gg, Gg, Gg, Gg
Gg, Gg, Gg^Efm, Gg^Efm, Gg^Efm, Gg^Efm, Wwf^Efm, Gg^Efm, Gg, Gg, Gll^Fdf, Gs^Fds, Gg, Gll, Gg, Gg, Gs^Fds, Gs^Fds, Gs^Fds, Gs^Fds, Gs^Fds, Hh, Gll^Fmf, Gll^Fmf, Gs^Fds, Gll^Fdf, Gs^Fds, Gs^Fds, Gs^Fds, Gg, Gll^Fdf, Gll^Fdf, Gll^Fdf, Gs^Fds, Gs^Fds, Gs^Fds, Gs^Fds, Gll^Fdf, Gg, Gg, Gll, Gs^Fds, Gs^Fds, Gg, Gs^Fds, Gll^Fdf, Gll, Gg, Gs^Fds, Gs^Fds, Gll^Fmf, Gll^Fdf, Gs^Fds, Gg, Gg, Gll^Fmf, Gs^Fds, Gll^Fdf, Gll^Fdf, Gll^Fmf, Gg, Gg, Gg, Gs^Fds, Gs^Fds, Gg, Gg, Gg, Gg
Gg, Gg, Gg, Gg^Efm, Gg^Efm, Gg^Efm, Wwf^Efm, Gg^Efm, Gg, Gs^Fds, Gg, Gll^Fdf, Gg, Gs^Fds, Gg, Gll^Fmf, Gs^Fds, Gll^Fmf, Gs^Fds, Gll^Fmf, Gll^Fmf, Gs^Fds, Gs^Fds, Gs^Fds, Gs^Fds, Gs^Fds, Hh, Gs^Fds, Gll^Fmf, Gll^Fmf, Gs^Fds, Gll^Fmf, Gg^Ve, Gs^Fds, Gg, Gs^Fds, Gll^Fdf, Gs^Fds, Gs^Fds, Gs^Fds, Gll, Gs^Fds, Gg, Gs^Fds, Gg, Gll^Fmf, Gg, Gs^Fds, Gs^Fds, Gg, Gll^Fdf, Gll^Fdf, Gs^Fds, Gs^Fds, Gg, Gll, Gg^Ve, Gg, Gs^Fds, Gll^Fmf, Gg, Gs^Fds, Gs^Fds, Gs^Fds, Gs^Fds, Gg, Gg, Gg, Gg
Gg, Gg, Gg, Gg, Gg, Gg^Efm, Wwf^Em, Gs^Fds, Gg, Gg, Gll^Fdf, Gll^Fmf, Gll, Gs^Fds, Gs^Fds, Gll^Fmf, Gs^Fds, Re, Gs^Fds, Gs^Fds, Gs^Fds, Gll, Gll^Fmf, Gll^Fdf, Gll^Fmf, Gs^Fds, Gll^Fmf, Gll^Fmf, Gll, Hh, Gs^Fds, Gs^Fds, Gs^Fds, Gs^Fds, Gs^Fds, Gs^Fds, Gs^Fds, Gll^Fdf, Gll^Fmf, Gll^Fmf, Gs^Fds, Gs^Fds, Gg, Gs^Fds, Gll^Fdf, Gll, Gg, Gs^Fds, Gs^Fds, Gll^Fdf, Gs^Fds, Gll^Fdf, Gg, Gs^Fds, Gs^Fds, Gs^Fds, Gll, Gg, Gll^Fdf, Gg, Gll^Fdf, Gg, Gs^Fds, Gg, Gs^Fds, Gg, Gg, Gg, Gg
Gg, Gg, Gg, Gg, Gg, Gg, Gs^Fds, Wwf^Es, Gll^Fdf, Gg, Gs^Fds, Gs^Fds, Gll^Fmf, Gs^Fds, Gg, Gs^Fds, Gg, Re, Gs^Fds, Gs^Fds, Gll^Fmf, Gll^Fdf, Gll^Fmf, Gll^Fdf, Gs^Fds, Gs^Fds, Gll, Gll^Fmf, Gll^Fmf, Gs^Fds, Gs^Fds, Hh, Gs^Fds, Gs^Fds, Gll^Fmf, Gg, Gs^Fds, Gg, Gs^Fds, Gs^Fds, Gs^Fds, Gll^Fdf, Gg^Ve, Gll^Fmf, Gll, Gg, Gs^Fds, Gll^Fdf, Gs^Fds, Gll^Fdf, Gll^Fmf, Gs^Fds, Gs^Fds, Gg, Gll, Gg, Gg, Gg, Gs^Fds, Gll^Fdf, Gll^Fdf, Gll^Fdf, Gll^Fdf, Gs^Fds, Gg, Gg, Gg, Gg, Gg
Gg, Gg, Gg, Gg^Gvs, Gg, Gg, Gg, Wwf^Edt, Gs^Fds, Gg, Gll, Gll^Fdf, Gg, Gs^Fds, Gg, Gs^Fds, Gll^Fmf, Re, Gll^Fmf, Gs^Fds, Gll^Fmf, Hh, Gs^Fds, Gs^Fds, Gll, Gs^Fds, Gs^Fds, Gll^Fmf, Hh, Gll^Fmf, Gll^Fdf, Gs^Fds, Gs^Fds, Gs^Fds, Gll^Fdf, Gs^Fds, Gs^Fds, Gs^Fds, Gll^Fdf, Gs^Fds, Gll, Gll, Gll^Fdf, Gs^Fds, Gs^Fds, Gs^Fds, Gs^Fds, Gs^Fds, Gll^Fdf, Gll^Fmf, Gg, Gg, Gg, Gll, Gg, Gg, Gs^Fds, Gg, Gg, Gg, Gll, Gs^Fds, Gs^Fds, Gs^Fds, Gs^Fds, Gg, Gg, Gg, Gg
Gg, Gg, Gg, Gg^Gvs, Gg, Gg, Gg, Wwf^Edt, Gg, Gs^Fds, Gs^Fds, Gs^Fds, Gll^Fmf, Gs^Fds, Gll^Fmf, Gs^Fds, Gs^Fds, Re, Re, Gs^Fds, Gs^Fds, Gs^Fds, Gg^Ve, Gll, Gs^Fds, Gll^Fdf, Gs^Fds, Gll^Fmf, Gs^Fds, Gs^Fds, Gll, Gll^Fmf, Gs^Fds, Gll, Hh^Fds, Gll^Fmf, Gll^Fdf, Gll^Fdf, Gs^Fds, Gs^Fds, Gll^Fdf, Hh^Fds, Gs^Fds, Gs^Fds, Gll^Fdf, Gll^Fdf, Gll, Gs^Fds, Gll, Gll^Fdf, Gg, Gs^Fds, Gs^Fds, Gg, Gs^Fds, Gs^Fds, Gll, Gg, Gs^Fds, Gll, Gs^Fds, Gs^Fds, Gs^Fds, Gs^Fds, Gg, Gg, Gg, Gg, Gg
Gg, Gg, Gg, Gg, Gg, Gg, Wwf^Edb, Wwf^Es, Gll^Fmf, Gg^Ve, Gs^Fds, Gs^Fds, Gll, Gll^Fdf, Gll^Fdf, Gs^Fds, Re, Hhd, Re, Gs^Fds, Gll^Fmf, Gs^Fds, Gll, Gs^Fds, Gs^Fds, Gs^Fds, Gll^Fdf, Gs^Fds, Gs^Fds, Gs^Fds, Gs^Fds, Gll^Fmf, Gg, Gs^Fds, Gg, Gs^Fds, Gs^Fds, Hh^Fds, Gs^Fds, Gll^Fdf, Gll^Fdf, Gs^Fds, Hh^Fds, Hh^Fds, Gs^Fds, Gs^Fds, Gs^Fds, Gll^Fmf, Gll^Fdf, Gs^Fds, Gs^Fds, Gg, Gs^Fds, Gg, Gs^Fds, Gg, Gs^Fds, Gs^Fds, Gg, Gll^Fdf, Gs^Fds, Gs^Fds, Gll^Fmf, Gll^Fmf, Gg, Gg, Gg, Gg, Gg
Gg, Gg, Gg, Gg, Gg, Gg, Wwf^Edb, Gll^Fmf, Gg, Gs^Fds, Gg, Gg, Gs^Fds, Gs^Fds, Gs^Fds, Re, Gs^Fds, Re, Re, Gll^Fmf, Gs^Fds, Gs^Fds, Gs^Fds, Hh, Gll^Fdf, Gll^Fmf, Gll^Fmf, Gll^Fmf, Gs^Fds, Gs^Fds, Gs^Fds, Gg, Gs^Fds, Gs^Fds, Gs^Fds, Gs^Fds, Gs^Fds, Gs^Fds, Hh^Fds, Hh^Fds, Hh, Hh, Hh^Vhh, Hh^Fds, Hh^Fds, Hh^Fds, Gll^Fdf, Gs^Fds, Gs^Fds, Gll^Fdf, Gs^Fds, Gll^Fdf, Gs^Fds, Gs^Fds, Gs^Fds, Gll^Fdf, Gs^Fds, Gll^Fdf, Gll^Fdf, Gs^Fds, Gs^Fds, Gg, Gs^Fds, Gg, Gg, Gg, Gs^Fds, Gg, Gg
Gg, Gg, Gg, Gg, Gg, Gg, Wwf^Edb, Gg, Gg, Gll^Fdf, Gg, Gll^Fdf, Re, Re, Gs^Fds, Re, Gs^Fds, Gs^Fds, Gs^Fds, Gs^Fds, Gll^Fmf, Gs^Fds, Hh, Hh, Gs^Fds, Gs^Fds, Hh, Gll^Fdf, Gll^Fmf, Gll^Fdf, Gll^Fmf, Gg, Gll^Fmf, Gll^Fmf, Cv, Cv, Ce, Hh^Fds, Hh^Fds, Gs^Fds, Hh, Hh^Fds, Hh, Hh^Fds, Hh^Fds, Hh^Fds, Gs^Fds, Gg^Ve, Gll^Fmf, Gll^Fdf, Gs^Fds, Gs^Fds, Gll^Fmf, Gs^Fds, Gs^Fds, Gll^Fmf, Gs^Fds, Gll^Fdf, Gll^Fdf, Gs^Fds, Gs^Fds, Gg, Gg, Gs^Fds, Gs^Fds, Gg, Gs^Fds, Gg, Gg
Gg, Gg, Gg, Gg, Gs^Vh, Gg, Gg, Wwf^Es, Gg, Gll^Fdf, Gll^Fdf, Re, Gll^Fdf, Gll^Fmf, Gll^Fdf, Gs^Fds, Gll^Fmf, Gs^Fds, Gs^Fds, Gll^Fdf, Gll^Fmf, Gll^Fmf, Gs^Fds, Gll^Fdf, Gs^Fds, Hh, Gll^Fdf, Gll^Fmf, Gs^Fds, Gs^Fds, Gll^Fdf, Gs^Fds, Gs^Edt, Gs^Fds, Gd^Edb, Gg^Fet, Gg^Dr, Gg, Cv, Hh^Fds, Gll^Fdf, Hh, Hh^Fds, Hh, Hh^Fds, Hh, Gll^Fdf, Gs^Fds, Gll^Fdf, Gs^Fds, Gll^Fmf, Gll^Fmf, Gs^Fds, Gs^Fds, Gll^Fmf, Gs^Fds, Gll^Fmf, Gs^Fds, Gs^Fds, Gg, Gll^Fmf, Gs^Fds, Gs^Fds, Gg, Gs^Fds, Gs^Fds, Gg, Gs^Fds, Gs^Fds
Gg, Gg, Re^Eff, Re^Eff, Re^Gvs, Re^Eff, Re^Eff, Wwf^Esd, Wwf^Esd, Gs^Fds, Gs^Fds, Re, Gs^Fds, Gll^Fdf, Gg^Efm, Gll^Fmf, Gs^Fds, Gg, Gg, Gs^Fds, Gs^Fds, Gs^Fds, Gll, Gll^Fdf, Gs^Fds, Gll^Fdf, Gs^Fds, Gll^Fmf, Gs^Fds, Gs^Fds, Cv, Ket, Gs^Edb, Gs^Edb, Gg^Ecf, Gd, Rp, Re^Vct, Gs, Cv, Gs^Fds, Gll^Edt, Gs^Fds, Hh, Hh, Gs^Fds, Hh^Fds, Gs^Fds, Gll^Fdf, Gll^Fmf, Hh^Fds, Gll, Gll^Fdf, Gs^Fds, Gs^Fds, Gg, Gg, Gll^Fmf, Gs^Fds, Gll^Fmf, Gs^Fds, Gg, Gs^Fds, Gll^Fdf, Gs^Fds, Gs^Fds, Gs^Fds, Gs^Fds, Gs^Fds
Re^Eff, Re^Eff, Re^Gvs, Re^Gvs, Re^Gvs, Re^Gvs, Re^Gvs, Re^Eff, Re^Eff, Wwf^Esd, Wwf^Edb, Re, Rb, Gs^Fds, Gg^Efm, Gg^Efm, Gll^Fdf, Gll^Fmf, Gll, Gs^Fds, Gs^Fds, Gs^Fds, Gs^Fds, Gll^Fmf, Gs^Fds, Gs^Fds, Ww, Ww, Ww, Gs^Fds, Gs^Fds, Gg^Ve, Rp, Rp, Rp, Rp, Cv, Rp, Rp^Edb, Gs^Edb, Gg^Ve, Gll^Fdf, Hh^Fds, Hh^Fds, Gs^Fds, Hh, Hh^Fds, Gll^Fdf, Gs^Fds, Gll^Fdf, Gs^Fds, Gs^Fds, Gs^Fds, Gll, Gll^Fmf, Gs^Fds, Gs^Fds, Gs^Fds, Gll^Fdf, Gs^Fds, Gg^Ve, Gll^Fmf, Gs^Fds, Gll^Fdf, Gll, Gll^Fdf, Gll^Fmf, Gll^Fmf, Gs^Fds
Re^Eff, Re^Gvs, Re^Gvs, Re^Gvs, Re^Gvs, Re^Gvs, Re^Eff, Re^Eff, Gg, Gs^Fds, Gll^Fmf, Wwf^Edt, Rb, Gs^Fds, Gs^Fds, Gs^Fds, Gll^Fdf, Gg, Gs^Fds, Gs^Fds, Gs^Fds, Gll, Gs^Fds, Gs^Fds, Gs^Fds, Ww, Ww, Gs^Fds, Gs^Fds, Ww, Cv, Gll^Edt, Rp, Cv, Gs, Gs, Ce, Cv, Re^Dr, Rp, Gs^Ecf, Cv, Ce, Gs^Fds, Hh, Gs^Fds, Gs^Fds, Gs^Fds, Gll^Fmf, Gs^Fds, Gll^Fdf, Gll^Fdf, Gll^Fdf, Gs^Fds, Gs^Fds, Gll^Fdf, Gs^Fds, Gs^Fds, Gs^Fds, Gll^Fdf, Gs^Fds, Gll^Fmf, Gs^Fds, Gs^Fds, Gs^Fds, Gll, Gs^Fds, Gll, Gg
Gg, Re^Eff, Re^Eff, Re^Gvs, Gs^Vh, Re^Eff, Gg, Gs^Fds, Gg, Gg, Wwf^Em, Wwf^Edt, Gll, Gll, Gll^Fdf, Gg^Ve, Gll^Fdf, Gs^Fds, Gs^Fds, Gll^Fdf, Gs^Fds, Gs^Fds, Ww, Gs^Fds, Ww, Ww, Gs^Fds, Gll^Fdf, Ww, Ww, Gs^Fds, Gd^Eb, Rp, Gd, Gd, Gg^Fet, Re^Vct, 2 Kv, Cv, Rp, Gg, Gd^Fetd, Gll, Gs^Fds, Hh^Fds, Hh^Fds, Hh^Fds, Gg, Gs^Fds, Gll^Fdf, Gs^Fds, Gs^Fds, Gs^Fds, Gs^Fds, Gs^Fds, Gs^Fds, Gg, Gs^Fds, Gs^Fds, Gs^Fds, Gll^Fmf, Gs^Fds, Gs^Fds, Gs^Fds, Gll, Gs^Fds, Ds, Ds, Ww
Gg, Gg, Gg, Gll, Gg, Gll, Gg, Gs^Fds, Gll^Fdf, Gll^Fdf, Wwf^Es, Gs^Fds, Rb, Rb, Rb, Gll^Fdf, Gs^Fds, Gs^Fds, Gs^Fds, Gs^Fds, Gll^Fdf, Ww, Gs^Fds, Ww, Gll^Fdf, Gs^Fds, Gs^Fds, Gs^Fds, Ww, Gs^Fds, Ce, Re^Vct, Rp, Cv, Gs^Edt, Gg^Ebn, Re^Dr, Cv, Ce, Rp, Gs, Re^Vct, Cv, Gs^Fds, Hh, Hh^Fds, Gll^Fdf, Gs^Fds, Gs^Eff, Gs^Fds, Re, Gll^Fdf, Gll^Fmf, Gll^Fmf, Gs^Fds, Gs^Fds, Gll^Fmf, Gll^Fmf, Gs^Fds, Gs^Fds, Gs^Fds, Gs^Fds, Gll^Fmf, Gs^Fds, Gs^Fds, Gs^Fds, Gs^Fds, Ww, Ww
Gg, Gg, Gg, Gg, Gg, Gg, Gll^Fmf, Gll^Fmf, Wwf^Em, Wwf^Em, Gg, Gs^Fds, Gll^Fdf, Gs^Fds, Gs^Fds, Rb, Wwf, Gs^Fds, Gs^Fds, Gs^Fds, Ww, Ww, Gs^Fds, Gs^Fds, Gll, Gll^Fdf, Gll^Fdf, Gs^Fds, Ww, Gs^Fds, Cv, Gs^Edb, Gs^Dr, Rp, Rp, Rp, Rp, Rp, Gd, Gd, Rp, Gs, Gs^Dr, Gs^Fds, Gg, Gs^Fds, Gs^Eff, Gs^Eff, Re, Gg, Re, Gs^Fds, Gg, Re, Re, Gll^Fdf, Gs^Fds, Gs^Fds, Gg, Gs^Fds, Gg, Gg, Gll^Fdf, Gs^Fds, Wwf, Wwf, Ww, Ww, Ww
Gg, Gg, Gg, Gg, Gg, Gg, Gll^Fdf, Gs^Fds, Wwf^Em, Gll^Fdf, Gll^Fdf, Gs^Fds, Gs^Fds, Gll^Fmf, Ww, Wwf, Gs^Fds, Ww, Ww, Ww, Gll^Fdf, Gll, Gs^Fds, Gs^Fds, Gll^Fdf, Gll^Fdf, Gs^Fds, Gs^Fds, Gs^Fds, Ww, Ww, Cv, Gs^Fds, Gd^Edb, Gd^Ecf, Gg^Ve, Gd^Fetd, Rp, Rp, Rp, Gg^Ve, Rp, Rp, Gs^Edt, Gll^Fmf, Gs^Eff, Gs^Eff, Re, Re, Re, Re, Re, Gll^Fdf, Gll, Gll^Fmf, Gs^Fds, Gll^Fdf, Gll^Fmf, Gs^Fds, Gs^Fds, Gs^Fds, Gs^Fds, Gs^Fds, Gg, Ww, Gs^Fds, Ww, Wo, Ww
Gg, Gg, Gg, Gg, Gg, Gg, Gg, Gg, Gg, Wwf^Ewf, Wwf^Ewl, Wwf^Ewl, Wwf^Ewl, Gs^Fds, Ww, Gs^Fds, Gs^Fds, Gs^Fds, Gs^Fds, Gll^Fdf, Gll^Fdf, Gll^Fdf, Gll^Fdf, Gll^Fdf, Gs^Fds, Gll, Gs^Fds, Gll^Fdf, Gs^Fds, Gs^Fds, Ww, Gs^Fds, Ww, Ce, Cv, Gll^Edb, Ce, Cv, Ww, Gs^Fds, Cv, Cv, Gg, Rp, Gll^Fdf, Gs^Eff, Re^Eff, Re, Gs, Re, Re, Re, Re, Re, Re, Re, Gll^Fmf, Gs^Fds, Gll^Fdf, Gll^Fdf, Gs^Fds, Ww, Gg, Ww, Ww, Ww, Ww, Ww, Ds
Gg, Gg, Gg, Gg, Gg, Gg, Gg, Gg, Gg, Gs^Fds, Ss, Gs^Fds, Ww, Ww, Gs^Fds, Gs, Gs^Fds, Gs^Fds, Gs^Fds, Gs^Fds, Gll, Gs^Fds, Gs^Fds, Gg, Gll^Fmf, Gll^Fmf, Gs^Fds, Gll^Fdf, Gll^Fmf, Gll^Fmf, Gs^Fds, Ww, Gs^Fds, Ww, Ww, Ww, Ww, Ww, Gs^Fds, Ww, Ww, Gs^Fds, Gs^Fds, Rp, Re, Re^Eff, Re^Edt, Re, Re, Re, Gs, Re, Gg^Esd, Gll^Fmf, Gs^Eff, Gs^Eff, Gll^Fmf, Ds, Ww, Gs^Fds, Ww, Ww, Ww, Ww, Ww, Gs^Fds, Ds, Ds, Gs^Fds
Ss, Gg, Gg, Gg, Gg, Gg, Gg, Gg, Ww^Ewf, Ww^Ewf, Ww, Ww^Ewf, Ss, Gs^Fds, Gs^Fds, Gs^Fds, Gll^Fdf, Gll^Fmf, Gs^Fds, Gll, Gs^Fds, Gll^Fdf, Gs^Fds, Gs^Fds, Gll^Fdf, Gs^Fds, Gll^Fdf, Gll^Fdf, Gll^Fdf, Gs^Fds, Gs^Fds, Gs^Fds, Gs^Fds, Gs^Fds, Gll^Fmf, Gll^Fmf, Gg, Gs^Fds, Gs^Fds, Gs^Fds, Ww, Cv, Kv, Gg, Re, Re, Gg, Re^Vct, Ce, Re, Re, Re^Vct, Gs^Eff, Gg, Gs^Eff, Gs^Eff, Gg, Gs^Fds, Ww, Ww, Ww, Wo, Ww, Gs^Fds, Ww, Gs^Fds, Gs^Fds, Gs^Fds, Gs^Fds
Ss, Ss, Gg, Ss, Gg, Gg, Ss, Gg, Ww^Ewf, Ww^Ewf, Gg, Ss, Gg, Gs^Fds, Rb, Gs^Fds, Gll^Fdf, Gll^Fdf, Gll^Fmf, Gll^Fdf, Gll^Fmf, Gs^Fds, Gll^Fdf, Gll^Fdf, Gs^Fds, Gs^Fds, Gll^Fmf, Gll^Fdf, Gll^Fdf, Gll^Fdf, Gll^Fmf, Gs^Fds, Gg, Gs^Fds, Gll^Fdf, Gs^Fds, Gs^Fds, Gs^Fds, Gs^Fds, Gg, Gs^Fds, Ww, Ww, Ww^Bw|, Gll^Fmf, Gs^Fds, Gs^Fds, Ce, 3 Ket, Gg^Ecf, Re, Gs^Eff, Re, Gs^Eff, Gs^Fds, Gg, Ww, Ww, Ww, Gs^Fds, Ww, Ww, Gs^Fds, Ww, Gs^Fds, Gs^Fds, Gs^Fds, Gs^Fds, Gll
Ss, Gg, Ss, Ss, Ss, Gg, Gg, Ss, Ww, Gg, Gg, Ss, Gg, Gll^Fdf, Rb, Gs^Fds, Gll^Fdf, Gg^Ve, Gs^Fds, Gs^Fds, Gs^Fds, Gs^Fds, Gs^Fds, Gll^Fdf, Gll^Fdf, Gs^Fds, Gll^Fmf, Gll^Fmf, Gs^Fds, Gs^Fds, Gs^Fds, Gs^Fds, Gs^Fds, Gs^Fds, Gll^Fmf, Gs^Fds, Gs^Fds, Gll^Fdf, Gll^Fdf, Gs, Gs, Gll^Fmf, Gs, Rp, Rp, Ww, Ww, Ww, Ww^Bw/, Re, Re, Wwr, Wwr, Ww^Bw|, Ww, Ww, Ww, Wwf, Ds, Ww, Gs^Fds, Gg, Gs^Fds, Gs^Fds, Gs^Fds, Gs^Fds, Gs^Fds, Gll, Gs^Fds
Gs^Fds, Ss, Ss, Gg, Ss, Ss, Ss, Sm, Sm, Ss, Ss, Gll^Fdf, Gg, Gs^Fds, Rb, Gg, Gg, Gll^Fdf, Gs^Fds, Gll^Fdf, Gs^Fds, Gs^Fds, Gs^Fds, Gs^Fds, Gll^Fdf, Gg^Ve, Gll^Fmf, Gs^Fds, Gll^Fdf, Gg, Gll, Gs^Fds, Gll^Fmf, Gs^Fds, Gg, Gs^Fds, Gs^Fds, Gll^Fmf, Gs^Fds, Gll^Fmf, Gs^Fds, Gs^Fds, Gs, Gll^Fdf, Gs, Gg, Rp, Cv, Ww^Bw\, Ww, Wwr, Wwf, Re, Ww^Bw|, Ww, Wo, Ww, Gs^Fds, Gg, Gg, Gs^Fds, Gs^Fds, Gs^Fds, Gs^Fds, Gll, Gs^Fds, Gg, Gll^Fdf, Gs^Fds
Gs^Fds, Ss, Ss, Gg, Gg, Ss, Gg, Gg, Gg^Em, Ss, Ss, Gg, Gg, Gll^Fdf, Rb, Gg, Gs^Fds, Gll^Fdf, Gll, Gll^Fdf, Gll, Gs^Fds, Gs^Fds, Gs^Fds, Gs^Fds, Gll^Fmf, Gs^Fds, Gs^Fds, Gs^Fds, Gll^Fdf, Gs^Fds, Gll^Fmf, Gll^Fmf, Gs^Fds, Gs^Fds, Gll^Fdf, Gs^Fds, Gs^Fds, Gs^Fds, Gg, Ds, Ds, Ww, Ww, Ww, Ww, Ww, Ww, Ww, Re, Ww^Bw\, Wwr, Re, Rp, Rp, Wwg, Re, Gs^Fds, Gs^Fds, Gs^Fds, Gll^Fmf, Gs^Fds, Gs^Fds, Gs^Fds, Gs^Fds, Gg^Ve, Gs^Fds, Gs^Fds, Gs^Fds
Ss, Ss, Ss, Ss^Vhs, Ss, Gg, Ss, Ss, Sm, Ss, Sm, Ss, Ss, Ss, Rb, Gg, Gg, Gg, Gg, Gs^Fds, Gs^Fds, Gll^Fmf, Gll^Fmf, Gs^Fds, Gs^Fds, Gs^Fds, Gll^Fmf, Gll, Gs^Fds, Gs^Fds, Gs^Fds, Gs^Fds, Gg, Gll^Fmf, Gll^Fdf, Gll^Fdf, Gll^Fmf, Gll^Fmf, Gs^Fds, Gs^Fds, Gs^Fds, Ww, Ww, Gs^Fds, Ww, Ww, Ww, Ww, Gs^Fds, Ww, Ds, Re, Re, Re, Re, Re, Re, Gs^Fds, Gs^Fds, Gs^Fds, Gs^Fds, Gs^Fds, Gll^Fdf, Gll^Fdf, Gll^Fdf, Gs^Fds, Gll^Fdf, Gs^Fds, Gs^Fds
Ss, Ss, Ss, Ss, Ss, Ss, Ss, Ss, Ss, Gg^Edt, Gg^Edb, Gs^Fds, Ss, Ss, Sm, Rb, Ss, Gg, Gg, Gs^Fds, Gs^Fds, Gs^Fds, Gs^Fds, Gll^Fmf, Gs^Fds, Gs^Fds, Gs^Fds, Gs^Fds, Gg, Gs^Fds, Gll^Fmf, Gs^Fds, Gs^Fds, Gll^Fmf, Gs^Fds, Gs^Fds, Gs^Fds, Gg^Ve, Gll^Fmf, Gs^Fds, Ww, Ww, Ww, Ww, Gg, Ww, Wwf, Wwf, Gs^Fds, Ds, Gs^Fds, Gs^Fds, Gll^Fmf, Re, Re, Re, Re, Gs^Fds, Gs^Fds, Gs^Fds, Gs^Fds, Gs^Fds, Gll, Gll^Fmf, Gs^Fds, Gs^Fds, Gll^Fdf, Gs^Fds, Gll^Fdf
Ss, Ss, Ss, Ss, Ss, Ss, Sm, Ss, Ss, Ss, Ss, Ss, Ss, Ss, Ss, Rb, Gg^Em, Ss, Gg, Gs^Fds, Gg, Gs^Fds, Gs^Fds, Gs^Fds, Gs^Fds, Gll^Fmf, Gs^Fds, Gs^Fds, Gs^Fds, Gs^Fds, Gs^Fds, Gll^Fdf, Gg, Gs^Fds, Gll, Gs^Fds, Gs^Fds, Gg, Gll^Fmf, Ww, Ww, Ww, Gs^Fds, Gs^Fds, Gs^Fds, Wwf, Gg, Gg, Gs^Fds, Gs^Fds, Gs^Fds, Gs^Fds, Gll^Fmf, Re, Gs^Fds, Rp, Gs, Re, Re, Re, Gs^Fds, Gll, Gs^Fds, Gs^Fds, Gs^Fds, Gs^Fds, Gs^Fds, Gs^Fds, Gs^Fds
Sm, Ss, Ss, Sm, Ss, Sm, Ss, Ss, Ss, Ss, Gs^Fds, Ss, Ss, Sm, Gg^Edb, Gg^Edt, Ss, Ss, Gs^Fds, Gg, Ss, Gg, Gs^Fds, Gs^Fds, Gs^Fds, Gll^Fdf, Gll^Fdf, Gs^Fds, Gll, Gll^Fmf, Gs^Fds, Gll^Fdf, Gs^Fds, Gs^Fds, Gg, Gll^Fmf, Gll^Fmf, Ww, Gs^Fds, Ww, Ds, Ds, Gs^Fds, Gs^Fds, Gg^Ve, Gs^Fds, Gs^Fds, Gs^Fds, Gs^Fds, Gs^Fds, Gll, Gs^Fds, Gs^Fds, Gs^Fds, Gll^Fmf, Re, Re, Rp, Re, Re, Re, Re, Gs^Fds, Gs^Fds, Gs^Fds, Gs^Fds, Gs^Fds, Gs^Fds, Gs^Fds
Ss, Ss, Gs^Fds, Sm, Ss, Ss, Ss, Ss, Gll^Fdf, Gll^Fdf, Ss, Sm, Ss, Ss, Ss, Ss, Ss, Ss, Gs^Fds, Ss, Ss, Gg, Gs^Fds, Gll, Gs^Fds, Gs^Fds, Gs^Fds, Gll^Fmf, Gll^Fmf, Gs^Fds, Gs^Fds, Gs^Fds, Gs^Fds, Gg, Gll^Fmf, Gs^Fds, Ww, Ww, Ww, Ww, Gg, Gs^Fds, Gs^Fds, Gs^Fds, Gll^Fmf, Gs^Fds, Gs^Fds, Gs^Fds, Gs^Fds, Gll^Fmf, Gs^Fds, Gll, Gs^Fds, Gs^Fds, Gs^Fds, Gll^Fmf, Gs^Fds, Re, Re, Re, Rp, Re, Re, Gs^Fds, Gs^Fds, Gll, Gll, Gs^Fds, Gs^Fds
Ss, Ss, Ss, Ss, Ss, Sm, Ss, Ss, Ss, Ss, Ss, Ss, Ss, Ss, Sm, Ss, Ss, Ss, Sm, Ss, Ss, Gs^Fds, Gs^Fds, Gg, Gg^Ve, Ss, Gs^Fds, Gg, Gs^Fds, Gs^Fds, Ds, Ds, Ww, Ww, Ww, Ww, Ww, Gs^Fds, Gg, Gg, Gs^Fds, Gs^Fds, Gll^Fmf, Gs^Fds, Gll, Gs^Fds, Gs^Fds, Gs^Fds, Gs^Fds, Gll^Fmf, Gs^Fds, Gll^Fmf, Gll^Fmf, Gs^Fds, Gll^Fdf, Gs^Fds, Gg, Re, Re, Re, Rp, Gll^Fdf, Re, Gll^Fdf, Gll^Fdf, Gs^Fds, Gs^Fds, Gs^Fds, Gs^Fds
Ss, Gg^Edb, Sm, Ss, Ss, Ss, Ss, Ss, Ss, Sm, Ss, Ss, Ss^Vhs, Ss, Gs^Fds, Ss, Ss, Sm, Ss, Sm, Ss, Sm, Gg^Em, Gs^Fds, Gs^Fds, Ss, Gg, Gll^Fdf, Gs^Fds, Gs^Fds, Ds, Ww, Gs^Fds, Ww, Gll^Fdf, Gs^Fds, Ds, Ds, Gs^Fds, Gs^Fds, Gll^Fmf, Gs^Fds, Gll, Gll, Gs^Fds, Gg, Gs^Fds, Gs^Fds, Gll^Fmf, Gs^Fds, Gs^Fds, Gll, Gs^Fds, Gs^Fds, Gs^Fds, Gs^Fds, Gs^Fds, Gll^Fdf, Gs^Fds, Gs^Fds, Gs, Re, Re, Re, Gs^Fds, Gll^Fdf, Gs^Fds, Gll^Fdf, Gs^Fds
Ss, Sm, Ss, Ss, Ss, Ss, Sm, Ss, Ss, Sm, Ss, Ss, Ss, Gs^Fds, Gs^Fds, Ss, Ss, Ss, Ss, Ss, Gs^Fds, Ss, Ss, Ss, Gs^Fds, Gs^Fds, Gs^Fds, Gll^Fdf, Gll^Fdf, Gll^Fdf, Gg, Ww, Ww, Ww, Gs^Fds, Gs^Fds, Gs^Fds, Gs^Fds, Gs^Fds, Gs^Fds, Gs^Fds, Gll^Fmf, Gll^Fmf, Gll^Fmf, Gll^Fdf, Gll^Fmf, Gll^Fmf, Gll^Fdf, Gs^Fds, Gs^Fds, Gll, Gll, Gll, Gs^Fds, Gs^Fds, Gll^Fdf, Gs^Fds, Gs^Fds, Gll^Fdf, Re, Re, Re, Rp, Re, Re, Gll^Fdf, Gll, Gs^Fds, Gll^Fdf
Ss, Ss, Ss, Ss, Ss, Ss, Ss, Sm, Ss, Ss, Gg, Ss, Ss, Gs^Fds, Ss, Ss, Ss, Ss, Ss, Ss, Gg^Edb, Ss, Ss, Ss, Gg, Gs^Fds, Ss, Gs^Fds, Gs^Fds, Gll^Fdf, Ww^Ewf, Ww^Ewl, Gg, Gs^Fds, Gll^Fdf, Gll^Fmf, Gll, Gs^Fds, Gs^Fds, Gs^Fds, Gs^Fds, Gs^Fds, Gll^Fmf, Gll^Fmf, Gs^Fds, Gs^Fds, Gll, Gs^Fds, Gll^Fmf, Gs^Fds, Gs^Fds, Gll^Fdf, Gll^Fdf, Gll, Gs^Fds, Gll, Gs^Fds, Gs^Fds, Gs^Fds, Gll^Fdf, Gll^Fmf, Re, Re, Rp, Rp, Gll, Gll^Fdf, Gs^Fds, Gll^Fdf
Gs^Fds, Sm, Ss^Vhs, Ss, Ss, Ss, Ss, Ss, Sm, Ss, Ss, Ss, Ss, Ss, Ss, Ss, Ss^Vhs, Ss, Ss, Ss, Ss, Gg^Edt, Ss, Gg^Em, Gg, Ss, Ww^Ewf, Gg, Ww, Gs^Fds, Wwf, Ss, Gg, Gs^Fds, Gll^Fdf, Gs^Fds, Gs^Fds, Gs^Fds, Gll, Gll, Gll, Gs^Fds, Gs^Fds, Gll^Fdf, Gll^Fdf, Gs^Fds, Gs^Fds, Gs^Fds, Gs^Fds, Gll, Gs^Fds, Gs^Fds, Gll^Fdf, Gs^Fds, Gll^Fdf, Gs^Fds, Gll^Fdf, Gs^Fds, Gs^Fds, Gs^Fds, Gll^Fdf, Gs^Fds, Gs^Fds, Re, Gs, Gs, Re, Gg^Ve, Gs^Fds
Ss, Sm, Ss, Ss, Gll^Fmf, Ss, Sm, Ss, Ss, Ss, Ss, Sm, Ss, Sm, Ss, Sm, Sm, Sm, Ss, Ss, Ss, Ss, Gs^Fds, Ss, Ww^Ewl, Ww, Gs^Fds, Ww^Ewl, Ss, Ww, Gs^Fds, Ds, Gs^Fds, Gll, Gs^Fds, Gll^Fmf, Gs^Fds, Gll^Fdf, Gs^Fds, Gll^Fdf, Gs^Fds, Gs^Fds, Gll^Fmf, Gs^Fds, Gs^Fds, Gs^Fds, Gll, Gll^Fdf, Gs^Fds, Gg^Ve, Gs^Fds, Gs^Fds, Gll, Gs^Fds, Gll, Gs^Fds, Gll^Fdf, Gll, Gs^Fds, Gs^Fds, Gs^Fds, Gs^Fds, Gll^Fdf, Re, Re, Rp, Re, Re, Gll
Ss, Ss, Ss, Ss, Ss, Ss, Ss, Ss, Ss, Ss, Ss, Ss, Gg, Gg, Gg, Ss, Ss, Ss, Ss, Ss, Ss, Ss, Ss, Ss, Ss, Gg, Ss, Gs^Fds, Gg, Gg, Gg, Gs^Fds, Gll^Fmf, Gll^Fmf, Gll, Gll^Fdf, Gs^Fds, Gs^Fds, Gs^Fds, Gg, Gll^Fmf, Gs^Fds, Gs^Fds, Gll^Fmf, Gs^Fds, Gs^Fds, Gs^Fds, Gs^Fds, Gll^Fdf, Gll^Fdf, Gs^Fds, Gs^Fds, Gg, Gs^Fds, Gs^Fds, Gs^Fds, Gs^Fds, Gs^Fds, Gs^Fds, Gll^Fdf, Gs^Fds, Gs^Fds, Gs^Fds, Re, Gs^Fds, Rp, Re, Re, Re
Ss, Ss, Sm, Ss, Ss, Ss, Ss, Sm, Ss, Sm, Ss, Ss, Gg, Gg, Gg, Ss, Ss, Ss, Ss, Ss, Sm, Ss, Ss, Gll^Fmf, Ss, Gg, Gs^Fds, Gg, Gg, Gs^Fds, Gs^Fds, Gs^Fds, Gg, Gs^Fds, Gll^Fdf, Gll^Fdf, Gs^Fds, Gs^Fds, Gs^Fds, Gg, Gll^Fmf, Gll^Fmf, Gll, Gg, Gll, Gs^Fds, Gs^Fds, Gll^Fdf, Gs^Fds, Gs^Fds, Gs^Fds, Gg, Gs^Fds, Gs^Fds, Gs^Fds, Gll^Fdf, Gs^Fds, Gs^Fds, Gs^Fds, Gs^Fds, Gs^Fds, Gs^Fds, Gll^Fdf, Re, Gs^Fds, Gg, Gs^Fds, Rp, Rp
Ss, Ss, Ss, Ss, Ss, Ss, Ss, Ss, Ss, Ss, Ss, Gs^Fds, Ss, Gg, Ss, Ss, Ss, Ss, Ss, Sm, Gs^Fds, Gg^Edt, Ss, Sm, Sm, Ss, Ss, Gs^Fds, Ss, Gg, Ss, Gg, Gs^Fds, Gg, Gs^Fds, Gll^Fdf, Gs^Fds, Gll, Gll, Gs^Fds, Gll^Fmf, Gs^Fds, Gg^Ve, Gs^Fds, Gs^Fds, Gs^Fds, Gll^Fdf, Gs^Fds, Gs^Fds, Gs^Fds, Gll^Fmf, Gs^Fds, Gs^Fds, Gs^Fds, Gs^Fds, Gs^Fds, Gs^Fds, Gs^Fds, Gll^Fmf, Gs^Fds, Gll, Gll^Fmf, Gll^Fdf, Gs^Fds, Gs^Fds, Gg, Gs^Fds, Gs^Fds, Gll^Fdf
Ss, Sm, Ss, Ss, Ss, Ss, Ss, Sm, Ss, Ss, Sm, Ss, Ss, Ss, Ss, Ss, Ss, Ss, Ss, Ss, Ss, Gg^Edb, Ss, Ss, Ss, Ss, Sm, Gs^Fds, Ss, Ss, Ss, Ss, Ss, Gg, Gs^Fds, Gll^Fmf, Gll^Fdf, Gs^Fds, Gll^Fdf, Gs^Fds, Gll^Fmf, Gll^Fdf, Gll^Fdf, Gs^Fds, Gs^Fds, Gll^Fdf, Gll, Gll, Gs^Fds, Gs^Fds, Gll^Fdf, Gll^Fmf, Gll^Fdf, Gs^Fds, Gll^Fmf, Gll^Fdf, Gs^Fds, Gs^Fds, Gs^Fds, Gll, Gs^Fds, Gll^Fdf, Gll^Fdf, Gll^Fdf, Gll^Fdf, Gg, Gs^Fds, Gs^Fds, Gs^Fds
Ss, Ss, Ss, Ss, Ss, Sm, Sm, Ss, Gs^Fds, Ss, Ss, Ss, Gll^Fmf, Ss, Sm, Ss, Ss^Vhs, Ss, Ss, Ss, Ss, Sm, Gs^Fds, Ss, Gs^Fds, Gs^Fds, Gll^Fdf, Ss, Ss, Gs^Fds, Gg, Gll^Fdf, Gs^Fds, Gg, Gg, Gg, Gll^Fmf, Gs^Fds, Gs^Fds, Gs^Fds, Gs^Fds, Gs^Fds, Gll, Gs^Fds, Gll^Fmf, Gs^Fds, Gll^Fmf, Gs^Fds, Gs^Fds, Gs^Fds, Gll^Fmf, Gg, Gs^Fds, Gll, Gll^Fdf, Gs^Fds, Gll^Fmf, Gll, Gs^Fds, Gs^Fds, Gs^Fds, Gs^Fds, Gs^Fds, Gs^Fds, Gll^Fdf, Gll^Fmf, Gll^Fdf, Gs^Fds, Gs^Fds
Ss, Ss, Ss, Ss, Ss, Ss, Sm, Ss, Ss, Ss, Ss, Ss, Gg^Edb, Ss, Ss, Ss, Gg^Edt, Ss, Ss, Sm, Ss, Ss, Ss, Ss, Ss, Gll^Fdf, Ss, Ss, Ss, Ss, Ss, Ss, Ss, Gg, Gs^Fds, Gg, Gs^Fds, Gll^Fmf, Gg, Gs^Fds, Gs^Fds, Gs^Fds, Gs^Fds, Gs^Fds, Gs^Fds, Gs^Fds, Gll^Fmf, Gg, Gs^Fds, Gs^Fds, Gs^Fds, Gll, Gs^Fds, Gll, Gll^Fdf, Gs^Fds, Gs^Fds, Gs^Fds, Gll^Fmf, Gs^Fds, Gs^Fds, Gs^Fds, Gs^Fds, Gll^Fdf, Gs^Fds, Gll^Fdf, Gs^Fds, Gll^Fmf, Gs^Fds
Gs^Fds, Ss, Sm, Ss, Ss, Ss, Ss, Ss, Ss, Ss, Sm, Ss, Ss, Sm, Ss, Ss, Ss, Gg^Edb, Ss, Sm, Ss, Ss, Ss, Sm, Ss, Ss, Gg, Ss, Sm, Ss, Ss, Ss, Gg, Ss, Gll^Fmf, Gg, Gg, Gg, Gs^Fds, Gg, Gll^Fmf, Gll^Fmf, Gll^Fmf, Gll, Gg, Gs^Fds, Gs^Fds, Gs^Fds, Gll, Gg, Gs^Fds, Gs^Fds, Gs^Fds, Gll, Gs^Fds, Gs^Fds, Gs^Fds, Gs^Fds, Gs^Fds, Gs^Fds, Gs^Fds, Gll^Fmf, Gs^Fds, Gg, Gg, Gs^Fds, Gs^Fds, Gll^Fmf, Gs^Fds
Ss, Gs^Fds, Sm, Sm, Ss, Ss, Ss, Gs^Fds, Ss, Ss, Ss, Ss, Ss, Ss, Ss, Ss, Ss, Gs^Fds, Ss, Ss, Ss, Ss, Ss, Ss, Ss, Ss, Ss, Gg, Ss, Ss, Ss, Gs^Fds, Sm, Sm, Gg, Ss, Gs^Fds, Gg, Gg, Gs^Fds, Gs^Fds, Gll^Fmf, Gs^Fds, Gll^Fmf, Gll, Gs^Fds, Gll^Fdf, Gs^Fds, Gll, Gll, Gs^Fds, Gg, Gll^Fmf, Gg, Gll^Fmf, Gs^Fds, Gll^Fmf, Gs^Fds, Gll, Gs^Fds, Gs^Fds, Gll^Fmf, Gs^Fds, Gs^Fds, Gg, Gs^Fds, Gll^Fdf, Gll^Fdf, Gs^Fds
Ss, Ss, Ss, Ss, Ss, Ss, Ss, Ss, Gs^Fds, Ss, Ss, Ss, Ss, Ss, Ss, Ss, Ss, Sm, Sm, Sm, Ss, Ss, Ss, Ss, Ss, Sm, Ss, Ss, Ss, Ss, Ss, Ss, Ss, Ss, Gs^Fds, Gg, Ss, Gg, Gs^Fds, Gg, Gs^Fds, Gs^Fds, Gs^Fds, Gll^Fmf, Gs^Fds, Gs^Fds, Gll^Fdf, Gs^Fds, Gll, Gg, Gs^Fds, Gs^Fds, Gs^Fds, Gs^Fds, Gs^Fds, Gs^Fds, Gll^Fmf, Gll^Fdf, Gs^Fds, Gs^Fds, Gs^Fds, Gll^Fp, Gs^Fds, Gs^Fds, Gg, Gs^Fds, Gs^Fds, Gs^Fds, Gs^Fds
